//MAP CONVERTED BY dmm2tgm.py THIS HEADER COMMENT PREVENTS RECONVERSION, DO NOT REMOVE
"a" = (
/turf/floor/natural/dirt,
/area/template_noop)
"n" = (
/turf/template_noop,
/area/template_noop)
"r" = (
/mob/living/simple_animal/passive/fox,
/obj/abstract/exterior_marker/inside,
/turf/floor/natural/dirt,
/area/shaded_hills/outside/point_of_interest/fox_den)
"x" = (
/turf/floor/natural/grass/wild,
/area/template_noop)
"y" = (
/obj/item/cash/imperial/quin,
/obj/item/cash/imperial/quin,
/obj/item/cash/imperial/quin,
/obj/item/cash/imperial/crown,
/obj/item/cash/imperial/crown,
/obj/item/clothing/ears/dangle/diamond,
/obj/abstract/exterior_marker/inside,
/obj/abstract/exterior_marker/inside,
/turf/floor/natural/dirt,
/area/shaded_hills/outside/point_of_interest/fox_den)
"B" = (
/turf/floor/natural/grass,
/area/template_noop)
"M" = (
/obj/abstract/exterior_marker/inside,
/obj/abstract/exterior_marker/inside,
/turf/wall/natural/dirt,
/area/shaded_hills/outside/point_of_interest/fox_den)
"O" = (
/obj/abstract/exterior_marker/inside,
/obj/abstract/exterior_marker/inside,
/turf/floor/natural/dirt,
/area/shaded_hills/outside/point_of_interest/fox_den)
"P" = (
/obj/item/food/butchery/offal/small,
/obj/item/stack/material/bone/mapped/bone,
/obj/abstract/exterior_marker/inside,
/obj/abstract/exterior_marker/inside,
/turf/floor/natural/dirt,
/area/shaded_hills/outside/point_of_interest/fox_den)
"S" = (
/obj/abstract/exterior_marker/inside,
/turf/floor/natural/dirt,
/area/shaded_hills/outside/point_of_interest/fox_den)
"W" = (
/obj/abstract/exterior_marker/inside,
/turf/wall/natural/dirt,
/area/shaded_hills/outside/point_of_interest/fox_den)
"Y" = (
/obj/item/seeds/extracted/foxglove,
/obj/abstract/exterior_marker/inside,
/turf/floor/natural/dirt,
/area/shaded_hills/outside/point_of_interest/fox_den)

(1,1,1) = {"
n
n
n
a
a
B
n
n
n
n
n
n
n
n
n
"}
(2,1,1) = {"
n
a
a
B
B
a
a
B
B
B
n
a
a
n
n
"}
(3,1,1) = {"
a
B
B
B
a
S
S
S
x
x
B
B
a
a
n
"}
(4,1,1) = {"
B
x
x
W
S
S
O
O
W
W
x
B
B
a
n
"}
(5,1,1) = {"
B
B
x
W
O
M
M
M
M
M
W
x
B
a
n
"}
(6,1,1) = {"
a
B
W
W
O
M
M
M
P
M
W
W
a
a
n
"}
(7,1,1) = {"
a
a
W
W
O
O
M
M
O
y
W
W
a
B
B
"}
(8,1,1) = {"
a
a
W
W
W
S
W
S
r
Y
W
W
B
B
B
"}
(9,1,1) = {"
n
a
B
W
W
S
S
S
S
W
W
W
B
x
B
"}
(10,1,1) = {"
n
B
B
W
M
M
O
S
W
W
W
B
x
x
B
"}
(11,1,1) = {"
n
B
B
B
W
W
M
W
W
W
a
x
x
B
B
"}
(12,1,1) = {"
n
a
a
B
B
x
W
W
a
x
x
x
B
B
a
"}
(13,1,1) = {"
n
n
a
a
a
B
x
x
x
x
x
a
B
a
a
"}
(14,1,1) = {"
n
n
n
n
a
B
B
x
x
B
a
a
a
a
n
"}
(15,1,1) = {"
n
n
n
n
n
a
a
B
B
B
a
n
n
n
n
"}
