//MAP CONVERTED BY dmm2tgm.py THIS HEADER COMMENT PREVENTS RECONVERSION, DO NOT REMOVE
"a" = (
/turf/space,
/area/space)
"b" = (
/turf/unsimulated/wall,
/area/test_area/proximity)
"c" = (
/turf/floor,
/area/test_area/proximity)
"d" = (
/turf/wall,
/area/test_area/proximity)
"e" = (
/obj/abstract/landmark/proximity_spawner,
/turf/floor,
/area/test_area/proximity)
"f" = (
/obj/abstract/landmark/proximity_wall,
/turf/wall,
/area/test_area/proximity)
"Q" = (
/obj/abstract/level_data_spawner/debug,
/turf/space,
/area/space)

(1,1,1) = {"
Q
a
a
a
a
a
a
a
a
a
a
"}
(2,1,1) = {"
a
b
b
b
b
b
b
b
b
b
a
"}
(3,1,1) = {"
a
b
c
c
c
c
c
c
c
b
a
"}
(4,1,1) = {"
a
b
c
d
d
d
d
d
c
b
a
"}
(5,1,1) = {"
a
b
c
d
c
c
c
d
c
b
a
"}
(6,1,1) = {"
a
b
c
d
c
e
c
f
c
b
a
"}
(7,1,1) = {"
a
b
c
d
c
c
c
d
c
b
a
"}
(8,1,1) = {"
a
b
c
d
d
d
d
d
c
b
a
"}
(9,1,1) = {"
a
b
c
c
c
c
c
c
c
b
a
"}
(10,1,1) = {"
a
b
b
b
b
b
b
b
b
b
a
"}
(11,1,1) = {"
a
a
a
a
a
a
a
a
a
a
a
"}
