//MAP CONVERTED BY dmm2tgm.py THIS HEADER COMMENT PREVENTS RECONVERSION, DO NOT REMOVE
"a" = (
/turf/space,
/area/test_area/edge_of_map)
"b" = (
/turf/unsimulated/wall,
/area/test_area/powered_dynamic_lighting)
"c" = (
/turf/unsimulated/wall,
/area/test_area/requires_power_dynamic_lighting)
"d" = (
/turf/unsimulated/floor{
	icon_state = "hydrofloor"
	},
/area/test_area/powered_dynamic_lighting)
"e" = (
/turf/unsimulated/floor{
	icon_state = "hydrofloor"
	},
/area/test_area/requires_power_dynamic_lighting)
"f" = (
/turf/unsimulated/wall,
/area/test_area/powered_non_dynamic_lighting)
"g" = (
/turf/unsimulated/wall,
/area/test_area/requires_power_non_dynamic_lighting)
"h" = (
/obj/abstract/landmark/test/virtual_spawn/two,
/turf/unsimulated/floor{
	icon_state = "hydrofloor"
	},
/area/test_area/powered_non_dynamic_lighting)
"i" = (
/turf/unsimulated/floor{
	icon_state = "hydrofloor"
	},
/area/test_area/powered_non_dynamic_lighting)
"j" = (
/obj/abstract/landmark/test/virtual_spawn/one,
/turf/unsimulated/floor{
	icon_state = "hydrofloor"
	},
/area/test_area/powered_non_dynamic_lighting)
"k" = (
/obj/abstract/landmark/test/virtual_spawn/three,
/turf/unsimulated/floor{
	icon_state = "hydrofloor"
	},
/area/test_area/powered_non_dynamic_lighting)
"l" = (
/turf/unsimulated/floor{
	icon_state = "hydrofloor"
	},
/area/test_area/requires_power_non_dynamic_lighting)
"m" = (
/turf/unsimulated/wall,
/area/test_area/general)
"n" = (
/turf/floor,
/area/test_area/general)
"o" = (
/turf/space,
/area/test_area/general)
"p" = (
/obj/abstract/landmark/test/safe_turf,
/turf/floor,
/area/test_area/general)
"q" = (
/obj/abstract/landmark/test/space_turf,
/turf/space,
/area/test_area/general)
"X" = (
/obj/abstract/level_data_spawner/debug,
/turf/unsimulated/floor{
	icon_state = "hydrofloor"
	},
/area/test_area/powered_dynamic_lighting)

(1,1,1) = {"
a
a
a
a
a
a
a
a
a
a
a
a
a
a
a
a
a
a
a
a
a
a
a
a
a
a
"}
(2,1,1) = {"
a
a
a
a
a
a
a
a
a
a
a
a
a
a
a
a
a
a
a
a
a
a
a
a
a
a
"}
(3,1,1) = {"
a
a
a
a
a
a
a
a
a
a
a
a
a
a
a
a
a
a
a
a
a
a
a
a
a
a
"}
(4,1,1) = {"
a
a
a
a
a
a
a
a
a
a
a
a
a
a
a
a
a
a
a
a
a
a
a
a
a
a
"}
(5,1,1) = {"
a
a
a
a
a
a
a
a
a
a
a
a
a
a
a
a
a
a
a
a
a
a
a
a
a
a
"}
(6,1,1) = {"
a
a
a
a
a
a
a
a
a
a
a
a
a
a
a
a
a
a
a
a
a
a
a
a
a
a
"}
(7,1,1) = {"
a
a
a
a
a
a
a
a
a
a
a
a
a
a
a
a
a
a
a
a
a
a
a
a
a
a
"}
(8,1,1) = {"
a
a
a
a
a
a
a
m
m
m
m
m
m
b
b
b
f
f
f
a
a
a
a
a
a
a
"}
(9,1,1) = {"
a
a
a
a
a
a
a
m
n
n
n
n
n
b
d
b
f
h
f
a
a
a
a
a
a
a
"}
(10,1,1) = {"
a
a
a
a
a
a
a
m
n
n
n
n
n
b
d
b
f
i
f
a
a
a
a
a
a
a
"}
(11,1,1) = {"
a
a
a
a
a
a
a
m
n
n
p
n
n
b
d
b
f
j
f
a
a
a
a
a
a
a
"}
(12,1,1) = {"
a
a
a
a
a
a
a
m
n
n
n
n
n
b
b
b
f
f
f
a
a
a
a
a
a
a
"}
(13,1,1) = {"
a
a
a
a
a
a
a
m
n
n
n
n
n
b
X
b
f
k
f
a
a
a
a
a
a
a
"}
(14,1,1) = {"
a
a
a
a
a
a
a
m
m
m
m
m
m
b
b
b
f
f
f
a
a
a
a
a
a
a
"}
(15,1,1) = {"
a
a
a
a
a
a
a
m
m
m
m
m
m
c
c
c
g
g
g
a
a
a
a
a
a
a
"}
(16,1,1) = {"
a
a
a
a
a
a
a
m
o
o
o
o
o
c
e
c
g
l
g
a
a
a
a
a
a
a
"}
(17,1,1) = {"
a
a
a
a
a
a
a
m
o
o
o
o
o
c
e
c
g
l
g
a
a
a
a
a
a
a
"}
(18,1,1) = {"
a
a
a
a
a
a
a
m
o
o
q
o
o
c
e
c
g
l
g
a
a
a
a
a
a
a
"}
(19,1,1) = {"
a
a
a
a
a
a
a
m
o
o
o
o
o
c
c
c
g
g
g
a
a
a
a
a
a
a
"}
(20,1,1) = {"
a
a
a
a
a
a
a
m
o
o
o
o
o
c
e
c
g
l
g
a
a
a
a
a
a
a
"}
(21,1,1) = {"
a
a
a
a
a
a
a
m
m
m
m
m
m
c
c
c
g
g
g
a
a
a
a
a
a
a
"}
(22,1,1) = {"
a
a
a
a
a
a
a
a
a
a
a
a
a
a
a
a
a
a
a
a
a
a
a
a
a
a
"}
(23,1,1) = {"
a
a
a
a
a
a
a
a
a
a
a
a
a
a
a
a
a
a
a
a
a
a
a
a
a
a
"}
(24,1,1) = {"
a
a
a
a
a
a
a
a
a
a
a
a
a
a
a
a
a
a
a
a
a
a
a
a
a
a
"}
(25,1,1) = {"
a
a
a
a
a
a
a
a
a
a
a
a
a
a
a
a
a
a
a
a
a
a
a
a
a
a
"}
(26,1,1) = {"
a
a
a
a
a
a
a
a
a
a
a
a
a
a
a
a
a
a
a
a
a
a
a
a
a
a
"}
(27,1,1) = {"
a
a
a
a
a
a
a
a
a
a
a
a
a
a
a
a
a
a
a
a
a
a
a
a
a
a
"}
(28,1,1) = {"
a
a
a
a
a
a
a
a
a
a
a
a
a
a
a
a
a
a
a
a
a
a
a
a
a
a
"}
