//MAP CONVERTED BY dmm2tgm.py THIS HEADER COMMENT PREVENTS RECONVERSION, DO NOT REMOVE
"a" = (
/turf/template_noop,
/area/template_noop)
"b" = (
/turf/wall/wood,
/area/template_noop)
"c" = (
/obj/machinery/port_gen/pacman,
/turf/floor/wood,
/area/template_noop)
"d" = (
/obj/structure/closet/cabinet,
/obj/item/clothing/jumpsuit/black,
/obj/item/clothing/shoes/jackboots/jungleboots,
/obj/item/clothing/mask/breath,
/turf/floor/carpet/green,
/area/template_noop)
"e" = (
/turf/floor/carpet/green,
/area/template_noop)
"f" = (
/obj/structure/bed,
/obj/item/bedsheet,
/turf/floor/carpet/green,
/area/template_noop)
"g" = (
/obj/structure/window/reinforced/full,
/turf/floor/wood,
/area/template_noop)
"h" = (
/obj/structure/table/woodentable,
/obj/item/board,
/turf/floor/wood,
/area/template_noop)
"i" = (
/obj/item/flashlight/lamp/green,
/obj/structure/table/woodentable,
/turf/floor/carpet/green,
/area/template_noop)
"j" = (
/obj/structure/table/woodentable,
/obj/item/clothing/mask/smokable/pipe/cobpipe,
/obj/item/chewables/rollable/generic,
/obj/item/ashtray,
/turf/floor/carpet/green,
/area/template_noop)
"k" = (
/obj/structure/table/woodentable,
/obj/item/utensil/fork/plastic,
/obj/item/utensil/fork/plastic,
/obj/item/utensil/fork/plastic,
/obj/item/utensil/knife,
/obj/effect/floor_decal/spline/fancy/wood/corner{
	dir = 1
	},
/turf/floor/tiled/monotile,
/area/template_noop)
"l" = (
/obj/structure/table/woodentable,
/obj/item/utensil/knife,
/obj/item/utensil/knife,
/obj/effect/floor_decal/spline/fancy/wood{
	dir = 1
	},
/turf/floor/tiled/monotile,
/area/template_noop)
"m" = (
/obj/structure/closet/crate/freezer,
/obj/effect/floor_decal/spline/fancy/wood{
	dir = 1
	},
/turf/floor/tiled/monotile,
/area/template_noop)
"n" = (
/obj/machinery/cooker/oven,
/obj/effect/floor_decal/spline/fancy/wood{
	dir = 4
	},
/obj/effect/floor_decal/spline/fancy/wood/corner{
	dir = 4
	},
/turf/floor/tiled/monotile,
/area/template_noop)
"o" = (
/turf/floor/wood,
/area/template_noop)
"p" = (
/obj/structure/bed/chair/wood{
	dir = 8
	},
/obj/effect/floor_decal/spline/fancy/wood/corner,
/turf/floor/wood,
/area/template_noop)
"q" = (
/obj/structure/table/woodentable,
/obj/item/book/manual/detective,
/obj/item/ashtray,
/obj/item/deck/cards,
/turf/floor/wood,
/area/template_noop)
"r" = (
/obj/effect/floor_decal/spline/fancy/wood{
	dir = 1
	},
/turf/floor/wood,
/area/template_noop)
"s" = (
/obj/structure/table/woodentable,
/obj/effect/decal/cleanable/blood/drip,
/obj/effect/decal/cleanable/blood/drip,
/obj/effect/decal/cleanable/blood/drip,
/obj/item/knife/kitchen/cleaver,
/turf/floor/tiled/monotile,
/area/template_noop)
"t" = (
/turf/floor/tiled/monotile,
/area/template_noop)
"u" = (
/obj/effect/floor_decal/spline/fancy/wood{
	dir = 4
	},
/turf/floor/tiled/monotile,
/area/template_noop)
"w" = (
/turf/floor/wood/usedup,
/area/template_noop)
"x" = (
/obj/structure/table/woodentable,
/obj/item/flashlight/lamp,
/obj/effect/floor_decal/spline/fancy/wood,
/turf/floor/tiled/monotile,
/area/template_noop)
"y" = (
/obj/effect/floor_decal/spline/fancy/wood,
/turf/floor/tiled/monotile,
/area/template_noop)
"z" = (
/obj/effect/floor_decal/spline/fancy/wood{
	dir = 6
	},
/turf/floor/tiled/monotile,
/area/template_noop)
"A" = (
/obj/effect/floor_decal/spline/fancy/wood{
	dir = 4
	},
/turf/floor/wood,
/area/template_noop)
"B" = (
/obj/effect/floor_decal/spline/fancy/wood/corner{
	dir = 1
	},
/turf/floor/wood,
/area/template_noop)
"C" = (
/obj/structure/table/woodentable,
/obj/machinery/computer/central_atmos/laptop{
	desc = "A cheap, beat-up old laptop.";
	name = "old laptop"
	},
/turf/floor/tiled/monotile,
/area/template_noop)
"D" = (
/obj/structure/bed/chair/wood{
	dir = 8
	},
/obj/effect/floor_decal/spline/fancy/wood{
	dir = 4
	},
/turf/floor/tiled/monotile,
/area/template_noop)
"E" = (
/obj/effect/floor_decal/spline/fancy/wood/corner,
/turf/floor/wood,
/area/template_noop)
"F" = (
/obj/effect/floor_decal/spline/fancy/wood,
/turf/floor/wood,
/area/template_noop)
"G" = (
/obj/effect/floor_decal/spline/fancy/wood/corner{
	dir = 8
	},
/turf/floor/wood,
/area/template_noop)
"H" = (
/obj/structure/door/wood,
/turf/floor/wood,
/area/template_noop)
"I" = (
/obj/structure/rack,
/obj/item/gun/projectile/zipgun,
/obj/item/box/ammo/shotgunshells,
/turf/floor/wood,
/area/template_noop)
"J" = (
/obj/structure/closet,
/obj/item/stack/material/sheet/mapped/steel/ten,
/obj/item/stack/material/plank/mapped/wood/fifty,
/obj/item/stack/tile/carpet/green/fifty,
/obj/item/stack/material/pane/mapped/rglass/ten,
/obj/effect/floor_decal/spline/fancy/wood/corner{
	dir = 8
	},
/turf/floor/wood,
/area/template_noop)
"L" = (
/obj/machinery/portable_atmospherics/hydroponics/soil,
/obj/item/seeds/towercap,
/turf/template_noop,
/area/template_noop)
"M" = (
/obj/machinery/portable_atmospherics/hydroponics/soil,
/obj/item/seeds/potatoseed,
/turf/template_noop,
/area/template_noop)
"O" = (
/obj/machinery/portable_atmospherics/hydroponics/soil,
/obj/item/seeds/wheatseed,
/turf/template_noop,
/area/template_noop)
"P" = (
/obj/machinery/portable_atmospherics/hydroponics/soil,
/obj/item/seeds/random,
/turf/template_noop,
/area/template_noop)
"Q" = (
/obj/machinery/portable_atmospherics/powered/scrubber,
/turf/floor/wood,
/area/template_noop)
"S" = (
/obj/machinery/portable_atmospherics/powered/scrubber,
/obj/effect/floor_decal/spline/fancy/wood/corner,
/turf/floor/wood,
/area/template_noop)

(1,1,1) = {"
a
a
a
b
b
b
b
a
a
a
a
"}
(2,1,1) = {"
a
a
a
b
t
C
b
a
a
a
a
"}
(3,1,1) = {"
b
b
b
b
u
D
b
a
a
a
a
"}
(4,1,1) = {"
b
d
i
r
w
E
b
a
a
a
a
"}
(5,1,1) = {"
b
e
e
r
o
F
g
L
L
a
a
"}
(6,1,1) = {"
b
e
e
r
o
F
g
a
a
a
a
"}
(7,1,1) = {"
b
f
j
r
o
G
b
L
M
a
a
"}
(8,1,1) = {"
b
b
b
b
b
H
b
a
a
a
a
"}
(9,1,1) = {"
a
b
k
s
x
E
b
M
O
a
a
"}
(10,1,1) = {"
a
g
l
t
y
F
g
a
a
a
a
"}
(11,1,1) = {"
a
g
m
t
y
G
b
M
P
a
a
"}
(12,1,1) = {"
a
b
n
u
z
w
b
b
b
b
b
"}
(13,1,1) = {"
a
b
o
o
o
o
o
w
Q
S
b
"}
(14,1,1) = {"
a
b
o
o
h
q
o
o
o
F
H
"}
(15,1,1) = {"
a
b
c
o
p
A
A
B
I
J
b
"}
(16,1,1) = {"
a
b
b
b
b
g
g
b
b
b
b
"}
