//MAP CONVERTED BY dmm2tgm.py THIS HEADER COMMENT PREVENTS RECONVERSION, DO NOT REMOVE
"a" = (
/turf/space,
/area/space)
"b" = (
/turf/wall,
/area/space)
"c" = (
/turf/floor/tiled,
/area/space)
"d" = (
/obj/abstract/landmark/latejoin/observer,
/turf/space,
/area/space)
"e" = (
/obj/abstract/landmark/latejoin,
/turf/floor/tiled,
/area/space)
"R" = (
/obj/abstract/level_data_spawner/player,
/turf/space,
/area/space)

(1,1,1) = {"
a
a
a
a
a
a
a
a
a
a
"}
(2,1,1) = {"
a
R
a
a
a
a
a
a
a
a
"}
(3,1,1) = {"
a
a
a
a
a
a
a
a
a
a
"}
(4,1,1) = {"
a
a
a
a
a
a
d
a
a
a
"}
(5,1,1) = {"
b
b
b
b
b
b
a
a
a
a
"}
(6,1,1) = {"
b
c
c
c
e
b
a
a
a
a
"}
(7,1,1) = {"
b
c
c
c
c
b
a
a
a
a
"}
(8,1,1) = {"
b
c
c
c
c
b
a
a
a
a
"}
(9,1,1) = {"
b
c
c
c
c
b
a
a
a
a
"}
(10,1,1) = {"
b
b
b
b
b
b
a
a
a
a
"}
