//MAP CONVERTED BY dmm2tgm.py THIS HEADER COMMENT PREVENTS RECONVERSION, DO NOT REMOVE
"aa" = (
/turf/space/infinity,
/area/space)
"ab" = (
/turf/unsimulated/wall,
/area/map_template/wizard_station)
"ac" = (
/obj/structure/table/woodentable,
/obj/item/storage/backpack/cultpack,
/turf/simulated/floor/carpet,
/area/map_template/wizard_station)
"ad" = (
/turf/unsimulated/wall/fakeglass{
	dir = 8;
	icon_state = "fakewindows2"
	},
/area/map_template/wizard_station)
"ae" = (
/turf/unsimulated/wall/fakeglass{
	dir = 4
	},
/area/map_template/wizard_station)
"af" = (
/obj/structure/table/woodentable,
/obj/item/storage/backpack/satchel/grey/withwallet,
/turf/simulated/floor/carpet,
/area/map_template/wizard_station)
"ag" = (
/turf/simulated/floor/carpet,
/area/map_template/wizard_station)
"ah" = (
/obj/structure/undies_wardrobe,
/turf/simulated/floor/carpet,
/area/map_template/wizard_station)
"ai" = (
/turf/unsimulated/wall/fakeglass{
	dir = 8
	},
/area/map_template/wizard_station)
"aj" = (
/obj/structure/door/wood,
/turf/simulated/floor/carpet,
/area/map_template/wizard_station)
"ak" = (
/obj/structure/table/woodentable,
/obj/item/flashlight/lamp/green{
	on = 0;
	pixel_x = -3;
	pixel_y = 8
	},
/obj/item/chems/drinks/flask/barflask,
/turf/simulated/floor/carpet,
/area/map_template/wizard_station)
"al" = (
/obj/structure/table/woodentable,
/obj/item/dice,
/turf/unsimulated/floor{
	dir = 8;
	icon_state = "wood"
	},
/area/map_template/wizard_station)
"am" = (
/obj/structure/bed/padded,
/obj/item/bedsheet/rd,
/turf/simulated/floor/carpet,
/area/map_template/wizard_station)
"an" = (
/obj/structure/table/woodentable,
/obj/item/dice/d20,
/turf/unsimulated/floor{
	dir = 8;
	icon_state = "wood"
	},
/area/map_template/wizard_station)
"ao" = (
/obj/structure/table/woodentable,
/obj/item/storage/backpack/satchel/grey/withwallet,
/obj/item/clothing/glasses/eyepatch/monocle,
/turf/simulated/floor/carpet,
/area/map_template/wizard_station)
"ap" = (
/mob/living/carbon/human/monkey{
	name = "Murphey"
	},
/turf/unsimulated/floor{
	dir = 8;
	icon_state = "wood"
	},
/area/map_template/wizard_station)
"aq" = (
/obj/structure/table/woodentable,
/obj/item/chems/food/chawanmushi,
/turf/unsimulated/floor{
	dir = 8;
	icon_state = "wood"
	},
/area/map_template/wizard_station)
"ar" = (
/obj/structure/table/woodentable,
/obj/effect/landmark{
	name = "Teleport-Scroll"
	},
/obj/item/toy/figure/ninja,
/turf/simulated/floor/carpet,
/area/map_template/wizard_station)
"as" = (
/obj/structure/table/woodentable,
/obj/item/megaphone,
/turf/unsimulated/floor{
	dir = 8;
	icon_state = "wood"
	},
/area/map_template/wizard_station)
"at" = (
/turf/unsimulated/floor{
	dir = 8;
	icon_state = "wood"
	},
/area/map_template/wizard_station)
"au" = (
/obj/structure/table/woodentable,
/obj/item/cash/c1,
/turf/unsimulated/floor{
	dir = 8;
	icon_state = "wood"
	},
/area/map_template/wizard_station)
"av" = (
/obj/structure/table/woodentable,
/obj/machinery/chemical_dispenser/bar_soft/full,
/obj/item/radio/intercom/syndicate{
	dir = 8;
	pixel_x = 22
	},
/turf/unsimulated/floor{
	dir = 8;
	icon_state = "wood"
	},
/area/map_template/wizard_station)
"aw" = (
/obj/machinery/vending/magivend,
/turf/unsimulated/floor{
	dir = 8;
	icon_state = "wood"
	},
/area/map_template/wizard_station)
"ax" = (
/obj/structure/bed/chair/wood/wings{
	dir = 8
	},
/turf/unsimulated/floor{
	dir = 8;
	icon_state = "wood"
	},
/area/map_template/wizard_station)
"ay" = (
/obj/effect/landmark/start{
	name = "wizard"
	},
/turf/simulated/floor/carpet,
/area/map_template/wizard_station)
"az" = (
/obj/structure/aliumizer,
/turf/simulated/floor/carpet,
/area/map_template/wizard_station)
"aA" = (
/obj/item/radio/intercom/syndicate{
	dir = 8;
	pixel_x = 22
	},
/turf/simulated/floor/carpet,
/area/map_template/wizard_station)
"aB" = (
/obj/structure/bookcase{
	name = "Forbidden Knowledge"
	},
/obj/effect/decal/cleanable/cobweb,
/turf/unsimulated/floor{
	dir = 8;
	icon_state = "wood"
	},
/area/map_template/wizard_station)
"aC" = (
/obj/structure/bookcase{
	name = "bookcase (Tactics)"
	},
/turf/unsimulated/floor{
	dir = 8;
	icon_state = "wood"
	},
/area/map_template/wizard_station)
"aD" = (
/obj/structure/bookcase,
/obj/item/book/manual/nuclear,
/turf/unsimulated/floor{
	dir = 8;
	icon_state = "wood"
	},
/area/map_template/wizard_station)
"aE" = (
/obj/structure/bookcase{
	name = "Forbidden Knowledge"
	},
/turf/unsimulated/floor{
	dir = 8;
	icon_state = "wood"
	},
/area/map_template/wizard_station)
"aF" = (
/turf/unsimulated/wall/fakeglass{
	dir = 1
	},
/area/map_template/wizard_station)
"aG" = (
/turf/unsimulated/floor{
	icon = 'icons/misc/beach.dmi';
	icon_state = "seashallow";
	name = "water"
	},
/area/map_template/wizard_station)
"aH" = (
/obj/structure/bookcase,
/obj/item/book/manual/robotics_cyborgs,
/turf/unsimulated/floor{
	dir = 8;
	icon_state = "wood"
	},
/area/map_template/wizard_station)
"aI" = (
/obj/item/bikehorn/rubberducky,
/turf/unsimulated/floor{
	icon = 'icons/misc/beach.dmi';
	icon_state = "seashallow";
	name = "water"
	},
/area/map_template/wizard_station)
"aJ" = (
/obj/effect/floor_decal/spline/fancy/wood{
	dir = 8
	},
/obj/machinery/acting/changer/mirror{
	pixel_y = 32
	},
/turf/unsimulated/floor{
	icon_state = "freezerfloor"
	},
/area/map_template/wizard_station)
"aK" = (
/obj/structure/hygiene/toilet{
	pixel_y = 8
	},
/turf/unsimulated/floor{
	icon_state = "freezerfloor"
	},
/area/map_template/wizard_station)
"aL" = (
/obj/structure/table/woodentable,
/obj/item/radio/intercom/syndicate{
	dir = 4;
	pixel_x = -22
	},
/turf/unsimulated/floor{
	dir = 8;
	icon_state = "wood"
	},
/area/map_template/wizard_station)
"aM" = (
/obj/structure/closet/coffin,
/turf/unsimulated/floor{
	icon_state = "cult";
	name = "plating"
	},
/area/map_template/wizard_station)
"aN" = (
/obj/structure/bed/chair/wood/wings{
	dir = 4
	},
/turf/unsimulated/floor{
	dir = 8;
	icon_state = "wood"
	},
/area/map_template/wizard_station)
"aO" = (
/obj/structure/table/woodentable,
/obj/item/storage/box/cups,
/turf/unsimulated/floor{
	dir = 8;
	icon_state = "wood"
	},
/area/map_template/wizard_station)
"aP" = (
/obj/structure/closet,
/obj/item/clothing/suit/wizrobe/red,
/obj/item/clothing/shoes/sandal,
/obj/item/clothing/head/wizard/red,
/obj/item/staff,
/turf/unsimulated/floor{
	icon_state = "lino"
	},
/area/map_template/wizard_station)
"aQ" = (
/obj/structure/table/woodentable,
/obj/item/storage/bag/cash,
/turf/unsimulated/floor{
	dir = 8;
	icon_state = "wood"
	},
/area/map_template/wizard_station)
"aR" = (
/obj/structure/closet,
/obj/item/clothing/suit/wizrobe/marisa,
/obj/item/clothing/shoes/sandal/marisa,
/obj/item/clothing/head/wizard/marisa,
/obj/item/staff/broom,
/turf/unsimulated/floor{
	icon_state = "lino"
	},
/area/map_template/wizard_station)
"aS" = (
/obj/structure/table/woodentable,
/obj/item/storage/candle_box,
/turf/unsimulated/floor{
	dir = 8;
	icon_state = "wood"
	},
/area/map_template/wizard_station)
"aT" = (
/obj/structure/closet,
/obj/item/clothing/suit/wizrobe/magusblue,
/obj/item/clothing/head/wizard/magus,
/obj/item/staff,
/turf/unsimulated/floor{
	icon_state = "lino"
	},
/area/map_template/wizard_station)
"aU" = (
/obj/structure/closet,
/obj/item/chems/drinks/bottle/pwine,
/obj/item/chems/drinks/bottle/agedwhiskey,
/obj/item/chems/drinks/bottle/cognac,
/turf/unsimulated/floor{
	icon_state = "lino"
	},
/area/map_template/wizard_station)
"aV" = (
/obj/effect/floor_decal/spline/fancy/wood{
	dir = 8
	},
/turf/unsimulated/floor{
	icon_state = "freezerfloor"
	},
/area/map_template/wizard_station)
"aW" = (
/turf/unsimulated/floor{
	icon_state = "freezerfloor"
	},
/area/map_template/wizard_station)
"aX" = (
/obj/structure/door/iron,
/turf/unsimulated/floor{
	icon_state = "freezerfloor"
	},
/area/map_template/wizard_station)
"aY" = (
/obj/structure/table/woodentable,
/obj/item/storage/box/donut,
/turf/unsimulated/floor{
	dir = 8;
	icon_state = "wood"
	},
/area/map_template/wizard_station)
"aZ" = (
/obj/structure/door/wood,
/turf/unsimulated/floor{
	icon_state = "lino"
	},
/area/map_template/wizard_station)
"ba" = (
/obj/structure/door/silver,
/turf/unsimulated/floor{
	dir = 8;
	icon_state = "wood"
	},
/area/map_template/wizard_station)
"bb" = (
/turf/unsimulated/floor{
	icon_state = "lino"
	},
/area/map_template/wizard_station)
"bc" = (
/turf/unsimulated/wall/fakeglass,
/area/map_template/wizard_station)
"bd" = (
/obj/item/soap,
/turf/unsimulated/floor{
	icon = 'icons/misc/beach.dmi';
	icon_state = "seashallow";
	name = "water"
	},
/area/map_template/wizard_station)
"be" = (
/obj/effect/floor_decal/spline/fancy/wood{
	dir = 8
	},
/obj/item/radio/intercom/syndicate{
	dir = 1;
	pixel_y = -22
	},
/turf/unsimulated/floor{
	icon_state = "freezerfloor"
	},
/area/map_template/wizard_station)
"bf" = (
/obj/structure/hygiene/sink{
	dir = 4;
	pixel_x = 11
	},
/obj/item/storage/mirror{
	pixel_x = 32
	},
/turf/unsimulated/floor{
	icon_state = "freezerfloor"
	},
/area/map_template/wizard_station)
"bg" = (
/obj/structure/table/woodentable,
/obj/item/chems/food/milosoup,
/turf/unsimulated/floor{
	dir = 8;
	icon_state = "wood"
	},
/area/map_template/wizard_station)
"bh" = (
/obj/structure/closet,
/obj/item/clothing/under/psysuit,
/obj/item/clothing/suit/wizrobe/psypurple,
/turf/unsimulated/floor{
	icon_state = "lino"
	},
/area/map_template/wizard_station)
"bi" = (
/turf/unsimulated/wall/fakeglass{
	dir = 1;
	icon_state = "fakewindows2"
	},
/area/map_template/wizard_station)
"bj" = (
/obj/structure/closet,
/obj/item/clothing/shoes/sandal/marisa{
	desc = "A set of fancy shoes that are as functional as they are comfortable.";
	name = "Gentlemans Shoes"
	},
/obj/item/clothing/under/gentlesuit,
/obj/item/clothing/suit/wizrobe/gentlecoat,
/obj/item/clothing/head/wizard/cap,
/obj/item/staff/gentcane,
/obj/item/radio/intercom/syndicate{
	dir = 1;
	pixel_y = -22
	},
/turf/unsimulated/floor{
	icon_state = "lino"
	},
/area/map_template/wizard_station)
"bk" = (
/obj/structure/closet,
/obj/item/clothing/suit/wizrobe/magusred,
/obj/item/clothing/head/wizard/magus,
/obj/item/staff,
/turf/unsimulated/floor{
	icon_state = "lino"
	},
/area/map_template/wizard_station)
"bl" = (
/obj/structure/closet,
/obj/item/storage/briefcase,
/turf/unsimulated/floor{
	icon_state = "lino"
	},
/area/map_template/wizard_station)
"bm" = (
/obj/structure/bookcase,
/turf/unsimulated/floor{
	dir = 8;
	icon_state = "wood"
	},
/area/map_template/wizard_station)
"bn" = (
/obj/item/radio/intercom/syndicate{
	dir = 1;
	pixel_y = -22
	},
/turf/unsimulated/floor{
	dir = 8;
	icon_state = "wood"
	},
/area/map_template/wizard_station)
"bo" = (
/turf/unsimulated/floor{
	icon_state = "cult";
	name = "plating"
	},
/area/map_template/wizard_station)
"bp" = (
/obj/item/radio/intercom/syndicate{
	pixel_y = 22
	},
/turf/unsimulated/floor{
	icon_state = "cult";
	name = "plating"
	},
/area/map_template/wizard_station)
"bq" = (
/obj/structure/cult/pylon,
/turf/unsimulated/floor{
	icon_state = "cult";
	name = "plating"
	},
/area/map_template/wizard_station)
"br" = (
/obj/structure/kitchenspike,
/turf/unsimulated/floor{
	icon_state = "cult";
	name = "plating"
	},
/area/map_template/wizard_station)
"bs" = (
/obj/item/remains/human,
/turf/unsimulated/floor{
	icon_state = "lava";
	name = "plating"
	},
/area/map_template/wizard_station)
"bt" = (
/turf/unsimulated/floor{
	icon_state = "lava";
	name = "plating"
	},
/area/map_template/wizard_station)
"bu" = (
/turf/unsimulated/floor{
	icon_state = "grass0";
	name = "grass"
	},
/area/map_template/wizard_station)
"bv" = (
/obj/structure/flora/ausbushes/fullgrass,
/turf/unsimulated/floor{
	icon_state = "grass0";
	name = "grass"
	},
/area/map_template/wizard_station)
"bw" = (
/mob/living/simple_animal/hostile/creature{
	name = "Experiment 35b"
	},
/turf/unsimulated/floor{
	icon_state = "lava";
	name = "plating"
	},
/area/map_template/wizard_station)
"bx" = (
/obj/structure/cult/talisman,
/obj/item/knife/ritual,
/turf/unsimulated/floor{
	icon_state = "cult";
	name = "plating"
	},
/area/map_template/wizard_station)
"by" = (
/obj/structure/table/woodentable,
/obj/item/cat_hide,
/turf/unsimulated/floor{
	icon_state = "cult";
	name = "plating"
	},
/area/map_template/wizard_station)
"bz" = (
/obj/effect/gateway/active/cult,
/turf/unsimulated/floor{
	icon_state = "cult";
	name = "plating"
	},
/area/map_template/wizard_station)
"bA" = (
/obj/structure/table/marble,
/obj/item/flashlight/slime,
/turf/unsimulated/floor{
	icon_state = "cult";
	name = "plating"
	},
/area/map_template/wizard_station)
"bB" = (
/mob/living/simple_animal/hostile/retaliate/goat{
	name = "Experiment 97d"
	},
/turf/unsimulated/floor{
	icon_state = "grass0";
	name = "grass"
	},
/area/map_template/wizard_station)
"bC" = (
/obj/structure/flora/ausbushes/grassybush,
/turf/unsimulated/floor{
	icon_state = "grass0";
	name = "grass"
	},
/area/map_template/wizard_station)
"bD" = (
/obj/structure/flora/pottedplant/unusual,
/turf/unsimulated/floor{
	icon_state = "cult";
	name = "plating"
	},
/area/map_template/wizard_station)
"bE" = (
/turf/unsimulated/floor{
	icon_state = "asteroid"
	},
/area/map_template/wizard_station)
"bF" = (
/obj/effect/overlay/palmtree_r,
/turf/unsimulated/floor{
	icon_state = "asteroid"
	},
/area/map_template/wizard_station)
"bG" = (
/mob/living/simple_animal/crab{
	name = "Experiment 68a"
	},
/turf/unsimulated/floor{
	icon_state = "asteroid"
	},
/area/map_template/wizard_station)
"bH" = (
/obj/effect/overlay/coconut,
/turf/unsimulated/floor{
	icon_state = "asteroid"
	},
/area/map_template/wizard_station)

(1,1,1) = {"
aa
aa
aa
aa
aa
aa
aa
aa
aa
aa
aa
aa
aa
aa
aa
aa
aa
aa
aa
aa
aa
aa
aa
aa
aa
aa
aa
aa
aa
aa
aa
aa
aa
aa
aa
aa
aa
"}
(2,1,1) = {"
aa
aa
aa
aa
aa
aa
aa
aa
aa
aa
aa
aa
aa
aa
aa
aa
aa
aa
aa
aa
aa
aa
aa
aa
aa
aa
aa
aa
aa
aa
aa
aa
aa
aa
aa
aa
aa
"}
(3,1,1) = {"
aa
aa
aa
aa
aa
aa
aa
aa
aa
aa
aa
aa
aa
aa
aa
aa
aa
aa
aa
aa
aa
aa
aa
aa
aa
aa
aa
aa
aa
aa
aa
aa
aa
aa
aa
aa
aa
"}
(4,1,1) = {"
aa
aa
aa
aa
aa
aa
aa
aa
aa
aa
aa
aa
aa
aa
aa
aa
aa
aa
aa
aa
aa
aa
aa
aa
aa
aa
aa
aa
aa
aa
aa
aa
aa
aa
aa
aa
aa
"}
(5,1,1) = {"
aa
aa
aa
aa
aa
aa
aa
aa
aa
aa
aa
aa
aa
aa
aa
aa
aa
aa
aa
aa
aa
aa
aa
aa
aa
aa
aa
aa
aa
aa
aa
aa
aa
aa
aa
aa
aa
"}
(6,1,1) = {"
aa
aa
aa
aa
aa
aa
aa
aa
aa
aa
aa
aa
aa
aa
aa
aa
aa
aa
aa
aa
aa
aa
aa
aa
aa
aa
aa
aa
aa
aa
aa
aa
aa
aa
aa
aa
aa
"}
(7,1,1) = {"
aa
aa
aa
aa
aa
aa
aa
aa
aa
aa
aa
aa
aa
aa
aa
aa
aa
aa
aa
aa
aa
aa
aa
aa
aa
aa
aa
aa
aa
aa
aa
aa
aa
aa
aa
aa
aa
"}
(8,1,1) = {"
aa
aa
aa
aa
aa
aa
aa
aa
aa
aa
ab
aF
bi
bc
ab
aa
aa
aa
aa
aa
aa
aa
ab
ab
ab
ab
ab
aa
aa
aa
aa
aa
aa
aa
aa
aa
aa
"}
(9,1,1) = {"
aa
aa
aa
aa
aa
aa
aa
aa
aa
aa
ab
aG
aG
bd
ab
aa
aa
aa
aa
aa
aa
aa
ab
bs
bt
bt
ab
aa
aa
aa
aa
aa
aa
aa
aa
aa
aa
"}
(10,1,1) = {"
aa
aa
aa
aa
aa
aa
aa
aa
aa
aa
ab
aI
aG
aG
ab
aa
aa
aa
aa
aa
aa
aa
ab
bt
bt
bt
ab
aa
aa
aa
aa
aa
aa
aa
aa
aa
aa
"}
(11,1,1) = {"
aa
aa
aa
aa
aa
aa
aa
aa
aa
aa
ab
aJ
aV
be
ab
aa
aa
aa
aa
aa
aa
aa
ab
bt
bw
bt
ab
aa
aa
aa
aa
aa
aa
aa
aa
aa
aa
"}
(12,1,1) = {"
aa
aa
aa
aa
aa
aa
aa
aa
aa
aa
ab
aK
aW
bf
ab
aa
aa
aa
aa
aa
aa
aa
ab
bt
bt
bs
ab
aa
aa
aa
aa
aa
aa
aa
aa
aa
aa
"}
(13,1,1) = {"
aa
aa
aa
aa
aa
aa
aa
aa
aa
ab
ab
ab
aX
ab
ab
ab
aa
aa
aa
aa
aa
ab
ab
aF
bi
bc
ab
ab
aa
aa
aa
aa
aa
aa
aa
aa
aa
"}
(14,1,1) = {"
aa
aa
aa
aa
aa
aa
aa
aa
ab
ab
aE
aL
at
aw
aD
ab
ab
aa
aa
aa
ab
ab
bq
bo
bx
bo
bq
ab
ab
aa
aa
aa
aa
aa
aa
aa
aa
"}
(15,1,1) = {"
aa
aa
aa
ab
ab
ab
ab
ab
ab
aB
at
at
at
at
at
bm
ab
aF
bi
bc
ab
aM
bo
bo
bo
bo
bo
bD
ab
ab
ab
ab
ab
ab
aa
aa
aa
"}
(16,1,1) = {"
aa
aa
aa
ai
ak
ar
ac
af
ab
al
at
aN
as
aN
at
aQ
ab
at
at
bn
ab
bo
bo
ai
ab
ai
bo
bo
ai
bE
bE
bE
bH
ab
aa
aa
aa
"}
(17,1,1) = {"
aa
aa
aa
ad
am
ay
ag
ag
aj
at
at
aq
aY
bg
at
at
ba
at
at
at
ba
bo
bo
ad
bz
ad
bo
by
ad
bE
bE
bG
bE
ab
aa
aa
aa
"}
(18,1,1) = {"
aa
aa
aa
ae
ao
az
aA
ah
ab
an
ap
ax
au
ax
at
aS
ab
at
at
at
ab
bp
bo
ae
ab
ae
bo
bo
ae
bE
bF
bE
bE
ab
aa
aa
aa
"}
(19,1,1) = {"
aa
aa
aa
ab
ab
ab
ab
ab
ab
aC
at
at
at
at
at
bm
ab
aF
bi
bc
ab
aM
bo
bo
bo
bo
bo
bD
ab
ab
ab
ab
ab
ab
aa
aa
aa
"}
(20,1,1) = {"
aa
aa
aa
aa
aa
aa
aa
aa
ab
ab
aC
aO
at
av
aH
ab
ab
aa
aa
aa
ab
ab
br
bo
bA
bo
br
ab
ab
aa
aa
aa
aa
aa
aa
aa
aa
"}
(21,1,1) = {"
aa
aa
aa
aa
aa
aa
aa
aa
aa
ab
ab
ab
aZ
ab
ab
ab
aa
aa
aa
aa
aa
ab
ab
aF
bi
bc
ab
ab
aa
aa
aa
aa
aa
aa
aa
aa
aa
"}
(22,1,1) = {"
aa
aa
aa
aa
aa
aa
aa
aa
aa
aa
ab
aP
bb
bh
ab
aa
aa
aa
aa
aa
aa
aa
ab
bu
bu
bC
ab
aa
aa
aa
aa
aa
aa
aa
aa
aa
aa
"}
(23,1,1) = {"
aa
aa
aa
aa
aa
aa
aa
aa
aa
aa
ab
aR
bb
bj
ab
aa
aa
aa
aa
aa
aa
aa
ab
bu
bu
bu
ab
aa
aa
aa
aa
aa
aa
aa
aa
aa
aa
"}
(24,1,1) = {"
aa
aa
aa
aa
aa
aa
aa
aa
aa
aa
ab
aT
bb
bk
ab
aa
aa
aa
aa
aa
aa
aa
ab
bu
bB
bu
ab
aa
aa
aa
aa
aa
aa
aa
aa
aa
aa
"}
(25,1,1) = {"
aa
aa
aa
aa
aa
aa
aa
aa
aa
aa
ab
aU
bb
bl
ab
aa
aa
aa
aa
aa
aa
aa
ab
bv
bu
bu
ab
aa
aa
aa
aa
aa
aa
aa
aa
aa
aa
"}
(26,1,1) = {"
aa
aa
aa
aa
aa
aa
aa
aa
aa
aa
ab
aF
bi
bc
ab
aa
aa
aa
aa
aa
aa
aa
ab
ab
ab
ab
ab
aa
aa
aa
aa
aa
aa
aa
aa
aa
aa
"}
(27,1,1) = {"
aa
aa
aa
aa
aa
aa
aa
aa
aa
aa
aa
aa
aa
aa
aa
aa
aa
aa
aa
aa
aa
aa
aa
aa
aa
aa
aa
aa
aa
aa
aa
aa
aa
aa
aa
aa
aa
"}
(28,1,1) = {"
aa
aa
aa
aa
aa
aa
aa
aa
aa
aa
aa
aa
aa
aa
aa
aa
aa
aa
aa
aa
aa
aa
aa
aa
aa
aa
aa
aa
aa
aa
aa
aa
aa
aa
aa
aa
aa
"}
(29,1,1) = {"
aa
aa
aa
aa
aa
aa
aa
aa
aa
aa
aa
aa
aa
aa
aa
aa
aa
aa
aa
aa
aa
aa
aa
aa
aa
aa
aa
aa
aa
aa
aa
aa
aa
aa
aa
aa
aa
"}
(30,1,1) = {"
aa
aa
aa
aa
aa
aa
aa
aa
aa
aa
aa
aa
aa
aa
aa
aa
aa
aa
aa
aa
aa
aa
aa
aa
aa
aa
aa
aa
aa
aa
aa
aa
aa
aa
aa
aa
aa
"}
(31,1,1) = {"
aa
aa
aa
aa
aa
aa
aa
aa
aa
aa
aa
aa
aa
aa
aa
aa
aa
aa
aa
aa
aa
aa
aa
aa
aa
aa
aa
aa
aa
aa
aa
aa
aa
aa
aa
aa
aa
"}
(32,1,1) = {"
aa
aa
aa
aa
aa
aa
aa
aa
aa
aa
aa
aa
aa
aa
aa
aa
aa
aa
aa
aa
aa
aa
aa
aa
aa
aa
aa
aa
aa
aa
aa
aa
aa
aa
aa
aa
aa
"}
(33,1,1) = {"
aa
aa
aa
aa
aa
aa
aa
aa
aa
aa
aa
aa
aa
aa
aa
aa
aa
aa
aa
aa
aa
aa
aa
aa
aa
aa
aa
aa
aa
aa
aa
aa
aa
aa
aa
aa
aa
"}
