//MAP CONVERTED BY dmm2tgm.py THIS HEADER COMMENT PREVENTS RECONVERSION, DO NOT REMOVE
"as" = (
/obj/machinery/atmospherics/unary/vent_pump/tank{
	dir = 1;
	id_tag = "tanker_output";
	pump_direction = 0
	},
/turf/simulated/floor/reinforced/oxygen,
/area/tanker)
"bb" = (
/obj/machinery/door/airlock/external/bolted_open{
	id_tag = "tanker_dock_interior_door"
	},
/turf/simulated/floor/plating,
/area/tanker)
"bd" = (
/obj/machinery/atmospherics/pipe/simple/hidden/supply,
/obj/machinery/atmospherics/pipe/simple/hidden/scrubbers,
/turf/simulated/floor/tiled/steel_grid,
/area/tanker)
"bC" = (
/obj/machinery/atmospherics/unary/engine{
	dir = 8
	},
/turf/simulated/floor/reinforced/airless,
/area/tanker)
"cT" = (
/obj/machinery/atmospherics/pipe/simple/hidden/supply,
/obj/machinery/atmospherics/pipe/simple/hidden/scrubbers,
/obj/structure/cable/blue{
	d1 = 1;
	d2 = 2;
	icon_state = "1-2"
	},
/turf/simulated/floor/tiled/steel_grid,
/area/tanker)
"cV" = (
/obj/machinery/embedded_controller/radio/airlock/docking_port{
	dir = 8;
	id_tag = "tanker_dock";
	pixel_x = 24;
	tag_airpump = "tanker_dock_pump";
	tag_chamber_sensor = "tanker_dock_sensor";
	tag_exterior_door = "tanker_dock_exterior_door";
	tag_interior_door = "tanker_dock_interior_door"
	},
/obj/structure/cable/green{
	d1 = 4;
	d2 = 8;
	icon_state = "4-8"
	},
/turf/simulated/floor/plating,
/area/tanker)
"dg" = (
/obj/effect/overmap/visitable/ship/landable/tanker,
/turf/simulated/floor/tiled/steel_grid,
/area/tanker)
"dJ" = (
/turf/simulated/floor/reinforced/airless,
/area/tanker)
"eb" = (
/obj/machinery/atmospherics/pipe/simple/hidden/scrubbers{
	dir = 9
	},
/obj/machinery/atmospherics/pipe/simple/hidden/supply{
	dir = 5
	},
/turf/simulated/floor/tiled/steel_grid,
/area/tanker)
"et" = (
/obj/machinery/atmospherics/pipe/simple/visible/green{
	dir = 4
	},
/turf/simulated/floor/reinforced/oxygen,
/area/tanker)
"eP" = (
/obj/machinery/computer/ship/helm{
	dir = 4
	},
/turf/simulated/floor/tiled/steel_grid,
/area/tanker)
"eQ" = (
/obj/machinery/atmospherics/pipe/manifold/hidden/fuel{
	dir = 8
	},
/turf/simulated/floor/reinforced/airless,
/area/tanker)
"fi" = (
/obj/machinery/atmospherics/pipe/simple/hidden/fuel{
	dir = 8
	},
/turf/simulated/floor/reinforced/oxygen,
/area/tanker)
"fp" = (
/obj/machinery/computer/air_control{
	dir = 4;
	input_tag = "tanker_input";
	output_tag = "tanker_output";
	sensor_name = "Main Tank";
	sensor_tag = "tanker_sensor"
	},
/turf/simulated/floor/tiled/steel_grid,
/area/tanker)
"fv" = (
/obj/machinery/light,
/turf/simulated/floor/tiled/steel_grid,
/area/tanker)
"fy" = (
/obj/machinery/atmospherics/unary/vent_pump/siphon/on/atmos/tank{
	dir = 4;
	id_tag = "tanker_fuel"
	},
/turf/simulated/floor/reinforced/oxygen,
/area/tanker)
"hQ" = (
/obj/machinery/air_sensor{
	id_tag = "tanker_sensor"
	},
/turf/simulated/floor/reinforced/oxygen,
/area/tanker)
"ia" = (
/obj/machinery/door/airlock/engineering,
/obj/machinery/atmospherics/pipe/simple/hidden/supply,
/obj/machinery/atmospherics/pipe/simple/hidden/scrubbers,
/turf/simulated/floor/tiled/steel_grid,
/area/tanker)
"ig" = (
/obj/effect/wallframe_spawn/reinforced,
/obj/machinery/atmospherics/pipe/simple/visible/green{
	dir = 4
	},
/turf/simulated/floor/plating,
/area/tanker)
"ix" = (
/obj/structure/cable/green{
	d1 = 4;
	d2 = 8;
	icon_state = "4-8"
	},
/obj/machinery/light{
	dir = 8
	},
/obj/machinery/atmospherics/pipe/simple/hidden/universal,
/turf/simulated/floor/plating,
/area/tanker)
"jh" = (
/turf/space,
/area/space)
"jp" = (
/obj/machinery/atmospherics/unary/vent_pump/high_volume/external_air{
	dir = 4;
	id_tag = "tanker_dock_pump"
	},
/obj/machinery/light{
	dir = 1
	},
/turf/simulated/floor/plating,
/area/tanker)
"jN" = (
/obj/machinery/atmospherics/pipe/simple/visible/green{
	dir = 10
	},
/turf/simulated/floor/plating,
/area/tanker)
"kN" = (
/obj/machinery/door/airlock/engineering,
/obj/machinery/atmospherics/pipe/simple/hidden/supply,
/obj/machinery/atmospherics/pipe/simple/hidden/scrubbers,
/obj/structure/cable/blue{
	d1 = 2;
	d2 = 5;
	icon_state = "2-5"
	},
/turf/simulated/floor/plating,
/area/tanker)
"la" = (
/obj/machinery/suit_cycler/generic/prepared,
/turf/simulated/floor/tiled/steel_grid,
/area/tanker)
"lr" = (
/obj/machinery/atmospherics/pipe/manifold4w/visible/green,
/turf/simulated/floor/reinforced/oxygen,
/area/tanker)
"lu" = (
/obj/machinery/atmospherics/portables_connector,
/obj/machinery/portable_atmospherics/canister/empty,
/obj/machinery/atmospherics/pipe/simple/hidden{
	dir = 4
	},
/turf/simulated/floor/plating,
/area/tanker)
"lU" = (
/turf/simulated/wall/r_wall/hull,
/area/tanker)
"qS" = (
/obj/machinery/atmospherics/portables_connector,
/obj/machinery/portable_atmospherics/canister/air,
/obj/machinery/atmospherics/pipe/simple/hidden{
	dir = 4
	},
/turf/simulated/floor/plating,
/area/tanker)
"rS" = (
/obj/machinery/computer/shuttle_control/explore{
	dir = 4;
	name = "shuttle control console";
	shuttle_tag = "Tanker"
	},
/turf/simulated/floor/tiled/steel_grid,
/area/tanker)
"sl" = (
/turf/simulated/floor/tiled/steel_grid,
/area/tanker)
"sp" = (
/obj/machinery/atmospherics/pipe/simple/hidden/fuel{
	dir = 5
	},
/turf/simulated/floor/reinforced/airless,
/area/tanker)
"sN" = (
/obj/machinery/shipsensors,
/turf/simulated/floor/plating,
/area/tanker)
"ul" = (
/obj/machinery/atmospherics/unary/vent_pump/tank{
	id_tag = "tanker_output";
	pump_direction = 0
	},
/turf/simulated/floor/reinforced/oxygen,
/area/tanker)
"vC" = (
/obj/machinery/atmospherics/pipe/simple/hidden/supply,
/obj/machinery/atmospherics/pipe/simple/hidden/scrubbers,
/obj/machinery/power/apc/high{
	dir = 4;
	pixel_x = 24
	},
/obj/structure/cable/blue,
/turf/simulated/floor/tiled/steel_grid,
/area/tanker)
"vT" = (
/turf/simulated/floor/plating,
/area/tanker)
"wS" = (
/obj/structure/cable/green{
	d1 = 4;
	d2 = 8;
	icon_state = "4-8"
	},
/turf/simulated/floor/plating,
/area/tanker)
"xA" = (
/obj/effect/shuttle_landmark/ship/tanker,
/turf/simulated/floor/reinforced/oxygen,
/area/tanker)
"yd" = (
/obj/machinery/atmospherics/pipe/simple/hidden/supply,
/obj/machinery/atmospherics/pipe/manifold/hidden/scrubbers{
	dir = 4
	},
/turf/simulated/floor/tiled/steel_grid,
/area/tanker)
"yv" = (
/obj/machinery/atmospherics/valve{
	dir = 8
	},
/turf/simulated/floor/tiled/steel_grid,
/area/tanker)
"yG" = (
/obj/structure/bed/chair/office,
/turf/simulated/floor/tiled/steel_grid,
/area/tanker)
"An" = (
/obj/machinery/atmospherics/pipe/manifold/visible/green{
	dir = 8
	},
/turf/simulated/floor/tiled/steel_grid,
/area/tanker)
"AH" = (
/obj/structure/bed,
/turf/simulated/floor/tiled/steel_grid,
/area/tanker)
"AM" = (
/obj/machinery/door/airlock/external/bolted{
	dir = 8;
	id_tag = "tanker_dock_exterior_door"
	},
/obj/machinery/atmospherics/valve/shutoff{
	dir = 8
	},
/turf/simulated/floor/plating,
/area/tanker)
"BD" = (
/obj/machinery/atmospherics/pipe/simple/hidden/scrubbers{
	dir = 9
	},
/obj/machinery/atmospherics/pipe/simple/visible/green{
	dir = 4
	},
/obj/structure/cable/blue{
	d1 = 1;
	d2 = 8;
	icon_state = "1-8"
	},
/obj/machinery/atmospherics/pipe/simple/hidden/supply{
	dir = 9
	},
/turf/simulated/floor/tiled/steel_grid,
/area/tanker)
"BI" = (
/obj/machinery/atmospherics/pipe/simple/hidden{
	dir = 4
	},
/obj/machinery/fabricator/pipe{
	anchored = 1
	},
/turf/simulated/floor/plating,
/area/tanker)
"Co" = (
/obj/machinery/door/airlock/external/bolted_open{
	id_tag = "tanker_dock_interior_door"
	},
/obj/machinery/atmospherics/pipe/simple/visible/green,
/turf/simulated/floor/plating,
/area/tanker)
"CD" = (
/obj/machinery/atmospherics/unary/vent_scrubber/on{
	dir = 4
	},
/obj/structure/bed/chair/shuttle{
	dir = 8
	},
/turf/simulated/floor/tiled/steel_grid,
/area/tanker)
"Dh" = (
/obj/machinery/computer/modular/preset/civilian{
	dir = 4
	},
/obj/machinery/light,
/turf/simulated/floor/tiled/steel_grid,
/area/tanker)
"DV" = (
/obj/machinery/atmospherics/pipe/simple/hidden/supply,
/obj/machinery/atmospherics/pipe/simple/hidden/scrubbers,
/obj/machinery/alarm{
	dir = 8;
	pixel_x = 24
	},
/turf/simulated/floor/tiled/steel_grid,
/area/tanker)
"FX" = (
/obj/machinery/computer/ship/engines{
	dir = 4
	},
/turf/simulated/floor/tiled/steel_grid,
/area/tanker)
"Gu" = (
/obj/structure/cable/blue{
	d2 = 10;
	icon_state = "0-10"
	},
/obj/machinery/power/smes/buildable/preset{
	_fully_charged = 1;
	_input_maxed = 1;
	_output_maxed = 1;
	_output_on = 1
	},
/obj/machinery/atmospherics/pipe/simple/hidden/scrubbers{
	dir = 9
	},
/turf/simulated/floor/plating,
/area/tanker)
"GF" = (
/turf/simulated/wall,
/area/tanker)
"HO" = (
/obj/machinery/atmospherics/pipe/simple/visible/green{
	dir = 4
	},
/obj/machinery/atmospherics/pipe/simple/hidden/scrubbers{
	dir = 6
	},
/obj/structure/cable/blue{
	d1 = 2;
	d2 = 4;
	icon_state = "2-4"
	},
/obj/machinery/atmospherics/pipe/simple/hidden/supply{
	dir = 6
	},
/obj/machinery/light{
	dir = 1
	},
/turf/simulated/floor/tiled/steel_grid,
/area/tanker)
"Iv" = (
/obj/machinery/door/airlock/external/bolted{
	dir = 8;
	id_tag = "tanker_dock_exterior_door"
	},
/turf/simulated/floor/plating,
/area/tanker)
"Jx" = (
/obj/machinery/door/airlock/external/bolted{
	dir = 8;
	id_tag = "tanker_dock_exterior_door"
	},
/obj/structure/cable/green{
	d1 = 4;
	d2 = 8;
	icon_state = "4-8"
	},
/turf/simulated/floor/plating,
/area/tanker)
"Km" = (
/obj/structure/table/rack,
/obj/item/storage/belt/utility/atmostech,
/obj/item/wrench,
/obj/item/twohanded/pipewrench,
/obj/item/radio/off,
/obj/item/radio/off,
/turf/simulated/floor/tiled/steel_grid,
/area/tanker)
"Na" = (
/obj/machinery/door/airlock/maintenance,
/turf/simulated/floor/reinforced/airless,
/area/tanker)
"Ni" = (
/obj/machinery/airlock_sensor{
	id_tag = "tanker_dock_sensor";
	pixel_y = 24
	},
/turf/simulated/floor/plating,
/area/tanker)
"Qj" = (
/obj/machinery/atmospherics/unary/vent_pump/on{
	dir = 8
	},
/turf/simulated/floor/tiled/steel_grid,
/area/tanker)
"Ro" = (
/obj/machinery/atmospherics/portables_connector{
	dir = 8
	},
/obj/machinery/portable_atmospherics/canister/air/airlock,
/turf/simulated/floor/plating,
/area/tanker)
"Rq" = (
/obj/structure/cable/green{
	d1 = 4;
	d2 = 8;
	icon_state = "4-8"
	},
/turf/simulated/wall,
/area/tanker)
"RC" = (
/obj/structure/table,
/turf/simulated/floor/tiled/steel_grid,
/area/tanker)
"Sf" = (
/obj/effect/wallframe_spawn/reinforced,
/obj/machinery/atmospherics/pipe/simple/hidden/fuel{
	dir = 8
	},
/turf/simulated/floor/plating,
/area/tanker)
"So" = (
/obj/machinery/atmospherics/unary/outlet_injector{
	dir = 4;
	id_tag = "tanker_input"
	},
/turf/simulated/floor/reinforced/oxygen,
/area/tanker)
"Td" = (
/turf/simulated/floor/reinforced/oxygen,
/area/tanker)
"Tr" = (
/obj/machinery/atmospherics/pipe/simple/hidden/scrubbers,
/obj/machinery/atmospherics/pipe/manifold/hidden/supply{
	dir = 4
	},
/obj/machinery/light{
	dir = 4
	},
/turf/simulated/floor/tiled/steel_grid,
/area/tanker)
"Uf" = (
/obj/machinery/atmospherics/unary/vent_scrubber/on{
	dir = 4
	},
/turf/simulated/floor/tiled/steel_grid,
/area/tanker)
"Uu" = (
/obj/machinery/atmospherics/unary/vent_pump/on{
	dir = 4
	},
/obj/structure/bed/chair/shuttle{
	dir = 8
	},
/turf/simulated/floor/tiled/steel_grid,
/area/tanker)
"Va" = (
/obj/machinery/computer/ship/sensors{
	dir = 4
	},
/turf/simulated/floor/tiled/steel_grid,
/area/tanker)
"VD" = (
/obj/machinery/atmospherics/pipe/manifold/hidden/fuel{
	dir = 1
	},
/turf/simulated/floor/reinforced/airless,
/area/tanker)
"WC" = (
/obj/machinery/atmospherics/valve/open{
	dir = 4
	},
/turf/simulated/floor/reinforced/airless,
/area/tanker)
"WG" = (
/obj/machinery/atmospherics/pipe/simple/hidden/supply,
/obj/machinery/atmospherics/pipe/simple/hidden/scrubbers{
	dir = 6
	},
/turf/simulated/floor/plating,
/area/tanker)
"WZ" = (
/obj/machinery/atmospherics/pipe/simple/hidden{
	dir = 4
	},
/turf/simulated/wall,
/area/tanker)
"YI" = (
/obj/machinery/power/terminal,
/obj/structure/cable/green{
	d2 = 8;
	icon_state = "0-8"
	},
/obj/machinery/atmospherics/pipe/simple/hidden/universal,
/turf/simulated/floor/plating,
/area/tanker)
"YS" = (
/obj/effect/wallframe_spawn/reinforced,
/turf/simulated/floor/plating,
/area/tanker)
"Ze" = (
/obj/structure/fuel_port/hydrogen,
/turf/simulated/wall/r_wall/hull,
/area/tanker)
"ZI" = (
/obj/structure/closet/emcloset,
/turf/simulated/floor/tiled/steel_grid,
/area/tanker)
"ZX" = (
/obj/machinery/door/airlock/external/bolted,
/turf/simulated/floor/plating,
/area/tanker)
"ZY" = (
/obj/machinery/atmospherics/portables_connector{
	dir = 1
	},
/turf/simulated/floor/tiled/steel_grid,
/area/tanker)

(1,1,1) = {"
jh
jh
jh
jh
jh
jh
jh
jh
jh
jh
jh
jh
jh
jh
jh
jh
jh
jh
jh
jh
jh
jh
jh
jh
jh
jh
jh
jh
jh
jh
jh
jh
jh
jh
jh
jh
jh
jh
jh
jh
jh
jh
jh
jh
jh
jh
jh
jh
jh
jh
jh
jh
jh
jh
jh
jh
jh
jh
jh
jh
"}
(2,1,1) = {"
jh
jh
jh
jh
jh
jh
jh
jh
jh
jh
jh
jh
jh
jh
jh
jh
jh
jh
jh
jh
jh
jh
jh
jh
jh
jh
jh
jh
jh
jh
jh
jh
jh
jh
jh
jh
jh
jh
jh
jh
jh
jh
jh
jh
jh
jh
jh
jh
jh
jh
jh
jh
jh
jh
jh
jh
jh
jh
jh
jh
"}
(3,1,1) = {"
jh
jh
jh
jh
jh
jh
jh
jh
jh
jh
jh
jh
jh
jh
jh
jh
jh
jh
jh
jh
jh
jh
jh
jh
jh
jh
jh
jh
jh
jh
jh
jh
jh
jh
jh
jh
jh
jh
jh
jh
jh
jh
jh
jh
jh
jh
jh
jh
jh
jh
jh
jh
jh
jh
jh
jh
jh
jh
jh
jh
"}
(4,1,1) = {"
jh
jh
jh
jh
jh
jh
jh
jh
jh
jh
jh
jh
jh
jh
jh
jh
jh
jh
jh
jh
jh
jh
jh
jh
jh
jh
jh
jh
jh
jh
jh
jh
jh
jh
jh
jh
jh
jh
jh
jh
jh
jh
jh
jh
jh
jh
jh
jh
jh
jh
jh
jh
jh
jh
jh
jh
jh
jh
jh
jh
"}
(5,1,1) = {"
jh
jh
jh
jh
jh
jh
jh
jh
jh
jh
jh
jh
jh
jh
jh
jh
jh
jh
jh
jh
jh
jh
jh
jh
jh
jh
jh
jh
jh
jh
jh
jh
jh
jh
jh
jh
jh
jh
jh
jh
jh
jh
jh
jh
jh
jh
jh
jh
jh
jh
jh
jh
jh
jh
jh
jh
jh
jh
jh
jh
"}
(6,1,1) = {"
jh
jh
jh
jh
jh
jh
jh
jh
jh
jh
jh
jh
jh
jh
jh
jh
jh
jh
jh
jh
jh
jh
jh
jh
jh
jh
jh
jh
jh
jh
jh
jh
jh
jh
jh
jh
jh
jh
jh
jh
jh
jh
jh
jh
jh
jh
jh
jh
jh
jh
jh
jh
jh
jh
jh
jh
jh
jh
jh
jh
"}
(7,1,1) = {"
jh
jh
jh
jh
jh
jh
jh
jh
jh
jh
jh
jh
jh
jh
jh
jh
jh
jh
jh
jh
jh
jh
jh
jh
jh
jh
jh
jh
jh
jh
jh
jh
jh
jh
jh
jh
jh
jh
jh
jh
jh
jh
jh
jh
jh
jh
jh
jh
jh
jh
jh
jh
jh
jh
jh
jh
jh
jh
jh
jh
"}
(8,1,1) = {"
jh
jh
jh
jh
jh
jh
jh
jh
jh
jh
jh
jh
jh
jh
jh
jh
jh
jh
jh
jh
jh
jh
jh
jh
jh
jh
jh
jh
jh
jh
jh
jh
jh
jh
jh
jh
jh
jh
jh
jh
jh
jh
jh
jh
jh
jh
jh
jh
jh
jh
jh
jh
jh
jh
jh
jh
jh
jh
jh
jh
"}
(9,1,1) = {"
jh
jh
jh
jh
jh
jh
jh
jh
jh
jh
jh
jh
jh
jh
jh
jh
jh
jh
jh
jh
jh
jh
jh
jh
jh
jh
jh
jh
jh
jh
jh
jh
jh
jh
jh
jh
jh
jh
jh
jh
jh
jh
jh
jh
jh
jh
jh
jh
jh
jh
jh
jh
jh
jh
jh
jh
jh
jh
jh
jh
"}
(10,1,1) = {"
jh
jh
jh
jh
jh
jh
jh
jh
jh
jh
jh
jh
jh
jh
jh
jh
jh
jh
jh
jh
jh
jh
jh
jh
jh
jh
jh
jh
jh
jh
jh
jh
jh
jh
jh
jh
jh
jh
jh
jh
jh
jh
jh
jh
jh
jh
jh
jh
jh
jh
jh
jh
jh
jh
jh
jh
jh
jh
jh
jh
"}
(11,1,1) = {"
jh
jh
jh
jh
jh
jh
jh
jh
jh
jh
jh
jh
jh
jh
jh
jh
jh
jh
jh
jh
jh
jh
jh
jh
jh
jh
jh
jh
jh
jh
jh
jh
jh
jh
jh
jh
jh
jh
jh
jh
jh
jh
jh
jh
jh
jh
jh
jh
jh
jh
jh
jh
jh
jh
jh
jh
jh
jh
jh
jh
"}
(12,1,1) = {"
jh
jh
jh
jh
jh
jh
jh
jh
jh
jh
jh
jh
jh
jh
jh
jh
jh
jh
jh
jh
jh
jh
jh
jh
jh
jh
jh
jh
jh
jh
jh
jh
jh
jh
jh
jh
jh
jh
jh
jh
jh
jh
jh
jh
jh
jh
jh
jh
jh
jh
jh
jh
jh
jh
jh
jh
jh
jh
jh
jh
"}
(13,1,1) = {"
jh
jh
jh
jh
jh
jh
jh
jh
jh
jh
jh
jh
jh
jh
jh
jh
jh
jh
jh
jh
jh
jh
jh
jh
jh
jh
jh
jh
jh
jh
jh
jh
jh
jh
jh
jh
jh
jh
jh
jh
jh
jh
jh
jh
jh
jh
jh
jh
jh
jh
jh
jh
jh
jh
jh
jh
jh
jh
jh
jh
"}
(14,1,1) = {"
jh
jh
jh
jh
jh
jh
jh
jh
jh
jh
jh
jh
jh
jh
jh
jh
jh
jh
jh
jh
jh
jh
jh
jh
jh
jh
jh
jh
jh
jh
jh
jh
jh
jh
jh
jh
jh
jh
jh
jh
jh
jh
jh
jh
jh
jh
jh
jh
jh
jh
jh
jh
jh
jh
jh
jh
jh
jh
jh
jh
"}
(15,1,1) = {"
jh
jh
jh
jh
jh
jh
jh
jh
jh
jh
jh
jh
jh
jh
jh
jh
jh
jh
jh
jh
jh
jh
jh
jh
jh
jh
jh
jh
jh
jh
jh
jh
jh
jh
jh
jh
jh
jh
jh
jh
jh
jh
jh
jh
jh
jh
jh
jh
jh
jh
jh
jh
jh
jh
jh
jh
jh
jh
jh
jh
"}
(16,1,1) = {"
jh
jh
jh
jh
jh
jh
jh
jh
jh
jh
jh
jh
jh
jh
jh
jh
jh
jh
jh
jh
jh
jh
jh
jh
jh
jh
jh
jh
jh
jh
jh
jh
jh
jh
jh
jh
jh
jh
jh
jh
jh
jh
jh
jh
jh
jh
jh
jh
jh
jh
jh
jh
jh
jh
jh
jh
jh
jh
jh
jh
"}
(17,1,1) = {"
jh
jh
jh
jh
jh
jh
jh
jh
jh
jh
jh
jh
jh
jh
jh
jh
jh
jh
jh
jh
jh
jh
jh
jh
jh
jh
jh
jh
jh
jh
jh
jh
jh
jh
jh
jh
jh
jh
jh
jh
jh
jh
jh
jh
jh
jh
jh
jh
jh
jh
jh
jh
jh
jh
jh
jh
jh
jh
jh
jh
"}
(18,1,1) = {"
jh
jh
jh
jh
jh
jh
jh
jh
jh
jh
jh
jh
jh
jh
jh
jh
jh
jh
jh
jh
jh
jh
jh
jh
jh
jh
jh
jh
jh
jh
jh
jh
jh
jh
jh
jh
jh
jh
jh
jh
jh
jh
jh
jh
jh
jh
jh
jh
jh
jh
jh
jh
jh
jh
jh
jh
jh
jh
jh
jh
"}
(19,1,1) = {"
jh
jh
jh
jh
jh
jh
jh
jh
jh
jh
jh
jh
jh
jh
jh
jh
jh
jh
jh
lU
Iv
Jx
AM
lU
lU
lU
YS
YS
YS
YS
YS
lU
lU
lU
lU
sN
jh
jh
jh
jh
jh
jh
jh
jh
jh
jh
jh
jh
jh
jh
jh
jh
jh
jh
jh
jh
jh
jh
jh
jh
"}
(20,1,1) = {"
jh
jh
jh
jh
jh
jh
jh
jh
jh
jh
jh
jh
jh
jh
jh
jh
jh
jh
jh
lU
Ni
wS
jN
Co
An
ZY
fp
rS
FX
eP
Va
GF
la
la
lU
lU
jh
jh
jh
jh
jh
jh
jh
jh
jh
jh
jh
jh
jh
jh
jh
jh
jh
jh
jh
jh
jh
jh
jh
jh
"}
(21,1,1) = {"
jh
jh
jh
jh
jh
jh
jh
jh
jh
jh
jh
jh
jh
jh
jh
jh
jh
jh
jh
Ze
jp
cV
vT
bb
yv
sl
sl
Uu
dg
CD
fv
GF
Uf
sl
Dh
lU
lU
lU
jh
jh
jh
jh
jh
jh
jh
jh
jh
jh
jh
jh
jh
jh
jh
jh
jh
jh
jh
jh
jh
jh
"}
(22,1,1) = {"
jh
jh
jh
jh
jh
jh
jh
jh
jh
jh
jh
jh
jh
jh
jh
jh
jh
jh
jh
lU
WZ
Rq
GF
GF
HO
cT
vC
Tr
DV
yd
bd
ia
eb
sl
yG
RC
AH
lU
jh
jh
jh
jh
jh
jh
jh
jh
jh
jh
jh
jh
jh
jh
jh
jh
jh
jh
jh
jh
jh
jh
"}
(23,1,1) = {"
jh
jh
jh
jh
jh
jh
jh
jh
jh
jh
jh
jh
jh
jh
jh
jh
jh
jh
jh
lU
qS
ix
WG
kN
BD
GF
GF
GF
GF
GF
GF
GF
Qj
sl
sl
sl
sl
lU
jh
jh
jh
jh
jh
jh
jh
jh
jh
jh
jh
jh
jh
jh
jh
jh
jh
jh
jh
jh
jh
jh
"}
(24,1,1) = {"
jh
jh
jh
jh
jh
jh
jh
jh
jh
jh
jh
jh
jh
jh
jh
jh
jh
jh
jh
lU
lu
YI
Gu
GF
ig
GF
Td
Td
Td
Td
Td
GF
ZX
GF
Km
sl
sl
lU
jh
jh
jh
jh
jh
jh
jh
jh
jh
jh
jh
jh
jh
jh
jh
jh
jh
jh
jh
jh
jh
jh
"}
(25,1,1) = {"
jh
jh
jh
jh
jh
jh
jh
jh
jh
jh
jh
jh
jh
jh
jh
jh
jh
jh
jh
lU
BI
vT
GF
GF
et
hQ
Td
Td
Td
Td
Td
Td
Td
GF
GF
sl
fv
lU
jh
jh
jh
jh
jh
jh
jh
jh
jh
jh
jh
jh
jh
jh
jh
jh
jh
jh
jh
jh
jh
jh
"}
(26,1,1) = {"
jh
jh
jh
jh
jh
jh
jh
jh
jh
jh
jh
jh
jh
jh
jh
jh
jh
jh
jh
lU
Ro
GF
GF
ul
lr
as
Td
Td
Td
Td
Td
Td
Td
Td
GF
GF
ZI
lU
jh
jh
jh
jh
jh
jh
jh
jh
jh
jh
jh
jh
jh
jh
jh
jh
jh
jh
jh
jh
jh
jh
"}
(27,1,1) = {"
jh
jh
jh
jh
jh
jh
jh
jh
jh
jh
jh
jh
jh
jh
jh
jh
jh
jh
jh
lU
GF
GF
Td
ul
lr
as
Td
Td
Td
Td
Td
Td
Td
Td
Td
GF
GF
lU
jh
jh
jh
jh
jh
jh
jh
jh
jh
jh
jh
jh
jh
jh
jh
jh
jh
jh
jh
jh
jh
jh
"}
(28,1,1) = {"
jh
jh
jh
jh
jh
jh
jh
jh
jh
jh
jh
jh
jh
jh
jh
jh
jh
jh
jh
lU
GF
Td
Td
ul
lr
as
Td
Td
Td
Td
Td
Td
Td
Td
Td
Td
GF
lU
jh
jh
jh
jh
jh
jh
jh
jh
jh
jh
jh
jh
jh
jh
jh
jh
jh
jh
jh
jh
jh
jh
"}
(29,1,1) = {"
jh
jh
jh
jh
jh
jh
jh
jh
jh
jh
jh
jh
jh
jh
jh
jh
jh
jh
jh
lU
Td
Td
Td
Td
So
Td
Td
Td
Td
Td
Td
Td
Td
Td
Td
Td
Td
lU
jh
jh
jh
jh
jh
jh
jh
jh
jh
jh
jh
jh
jh
jh
jh
jh
jh
jh
jh
jh
jh
jh
"}
(30,1,1) = {"
jh
jh
jh
jh
jh
jh
jh
jh
jh
jh
jh
jh
jh
jh
jh
jh
jh
jh
lU
lU
Td
Td
Td
Td
Td
Td
Td
Td
Td
Td
Td
Td
Td
Td
Td
Td
Td
lU
lU
jh
jh
jh
jh
jh
jh
jh
jh
jh
jh
jh
jh
jh
jh
jh
jh
jh
jh
jh
jh
jh
"}
(31,1,1) = {"
jh
jh
jh
jh
jh
jh
jh
jh
jh
jh
jh
jh
jh
jh
jh
jh
jh
jh
lU
Td
Td
Td
Td
Td
Td
Td
Td
Td
Td
Td
Td
Td
Td
Td
Td
Td
Td
Td
lU
jh
jh
jh
jh
jh
jh
jh
jh
jh
jh
jh
jh
jh
jh
jh
jh
jh
jh
jh
jh
jh
"}
(32,1,1) = {"
jh
jh
jh
jh
jh
jh
jh
jh
jh
jh
jh
jh
jh
jh
jh
jh
jh
jh
lU
Td
Td
Td
Td
Td
Td
Td
Td
Td
Td
Td
Td
Td
Td
Td
Td
Td
Td
Td
lU
jh
jh
jh
jh
jh
jh
jh
jh
jh
jh
jh
jh
jh
jh
jh
jh
jh
jh
jh
jh
jh
"}
(33,1,1) = {"
jh
jh
jh
jh
jh
jh
jh
jh
jh
jh
jh
jh
jh
jh
jh
jh
jh
jh
lU
Td
Td
Td
Td
Td
Td
Td
Td
Td
xA
Td
Td
Td
Td
Td
Td
Td
Td
Td
lU
jh
jh
jh
jh
jh
jh
jh
jh
jh
jh
jh
jh
jh
jh
jh
jh
jh
jh
jh
jh
jh
"}
(34,1,1) = {"
jh
jh
jh
jh
jh
jh
jh
jh
jh
jh
jh
jh
jh
jh
jh
jh
jh
jh
lU
Td
Td
Td
Td
Td
Td
Td
Td
Td
Td
Td
Td
Td
Td
Td
Td
Td
Td
Td
lU
jh
jh
jh
jh
jh
jh
jh
jh
jh
jh
jh
jh
jh
jh
jh
jh
jh
jh
jh
jh
jh
"}
(35,1,1) = {"
jh
jh
jh
jh
jh
jh
jh
jh
jh
jh
jh
jh
jh
jh
jh
jh
jh
jh
lU
Td
Td
Td
Td
Td
Td
Td
Td
Td
Td
Td
Td
Td
Td
Td
Td
Td
Td
Td
lU
jh
jh
jh
jh
jh
jh
jh
jh
jh
jh
jh
jh
jh
jh
jh
jh
jh
jh
jh
jh
jh
"}
(36,1,1) = {"
jh
jh
jh
jh
jh
jh
jh
jh
jh
jh
jh
jh
jh
jh
jh
jh
jh
jh
lU
lU
Td
Td
Td
Td
Td
Td
Td
Td
Td
Td
Td
Td
Td
Td
Td
Td
Td
lU
lU
jh
jh
jh
jh
jh
jh
jh
jh
jh
jh
jh
jh
jh
jh
jh
jh
jh
jh
jh
jh
jh
"}
(37,1,1) = {"
jh
jh
jh
jh
jh
jh
jh
jh
jh
jh
jh
jh
jh
jh
jh
jh
jh
jh
jh
lU
Td
Td
Td
Td
Td
Td
Td
Td
Td
Td
Td
Td
Td
Td
Td
Td
Td
lU
jh
jh
jh
jh
jh
jh
jh
jh
jh
jh
jh
jh
jh
jh
jh
jh
jh
jh
jh
jh
jh
jh
"}
(38,1,1) = {"
jh
jh
jh
jh
jh
jh
jh
jh
jh
jh
jh
jh
jh
jh
jh
jh
jh
jh
jh
lU
lU
Td
Td
Td
Td
Td
Td
Td
Td
Td
Td
Td
Td
Td
Td
Td
lU
lU
jh
jh
jh
jh
jh
jh
jh
jh
jh
jh
jh
jh
jh
jh
jh
jh
jh
jh
jh
jh
jh
jh
"}
(39,1,1) = {"
jh
jh
jh
jh
jh
jh
jh
jh
jh
jh
jh
jh
jh
jh
jh
jh
jh
jh
jh
jh
lU
lU
Td
Td
Td
Td
Td
Td
Td
Td
Td
Td
Td
Td
Td
lU
lU
jh
jh
jh
jh
jh
jh
jh
jh
jh
jh
jh
jh
jh
jh
jh
jh
jh
jh
jh
jh
jh
jh
jh
"}
(40,1,1) = {"
jh
jh
jh
jh
jh
jh
jh
jh
jh
jh
jh
jh
jh
jh
jh
jh
jh
jh
jh
jh
jh
lU
lU
Td
fy
Td
Td
Td
Td
Td
Td
Td
Td
Td
lU
lU
jh
jh
jh
jh
jh
jh
jh
jh
jh
jh
jh
jh
jh
jh
jh
jh
jh
jh
jh
jh
jh
jh
jh
jh
"}
(41,1,1) = {"
jh
jh
jh
jh
jh
jh
jh
jh
jh
jh
jh
jh
jh
jh
jh
jh
jh
jh
jh
jh
jh
jh
lU
lU
fi
Td
Td
Td
Td
Td
Td
Td
Td
lU
lU
jh
jh
jh
jh
jh
jh
jh
jh
jh
jh
jh
jh
jh
jh
jh
jh
jh
jh
jh
jh
jh
jh
jh
jh
jh
"}
(42,1,1) = {"
jh
jh
jh
jh
jh
jh
jh
jh
jh
jh
jh
jh
jh
jh
jh
jh
jh
jh
jh
jh
jh
jh
jh
lU
Sf
GF
Td
Td
Td
Td
Td
GF
YS
lU
jh
jh
jh
jh
jh
jh
jh
jh
jh
jh
jh
jh
jh
jh
jh
jh
jh
jh
jh
jh
jh
jh
jh
jh
jh
jh
"}
(43,1,1) = {"
jh
jh
jh
jh
jh
jh
jh
jh
jh
jh
jh
jh
jh
jh
jh
jh
jh
jh
jh
jh
jh
jh
jh
Na
WC
GF
GF
GF
GF
GF
GF
GF
dJ
Na
jh
jh
jh
jh
jh
jh
jh
jh
jh
jh
jh
jh
jh
jh
jh
jh
jh
jh
jh
jh
jh
jh
jh
jh
jh
jh
"}
(44,1,1) = {"
jh
jh
jh
jh
jh
jh
jh
jh
jh
jh
jh
jh
jh
jh
jh
jh
jh
jh
jh
jh
jh
jh
jh
lU
VD
eQ
eQ
eQ
eQ
eQ
eQ
eQ
sp
lU
jh
jh
jh
jh
jh
jh
jh
jh
jh
jh
jh
jh
jh
jh
jh
jh
jh
jh
jh
jh
jh
jh
jh
jh
jh
jh
"}
(45,1,1) = {"
jh
jh
jh
jh
jh
jh
jh
jh
jh
jh
jh
jh
jh
jh
jh
jh
jh
jh
jh
jh
jh
jh
jh
lU
bC
bC
bC
bC
bC
bC
bC
bC
bC
lU
jh
jh
jh
jh
jh
jh
jh
jh
jh
jh
jh
jh
jh
jh
jh
jh
jh
jh
jh
jh
jh
jh
jh
jh
jh
jh
"}
(46,1,1) = {"
jh
jh
jh
jh
jh
jh
jh
jh
jh
jh
jh
jh
jh
jh
jh
jh
jh
jh
jh
jh
jh
jh
jh
jh
jh
jh
jh
jh
jh
jh
jh
jh
jh
jh
jh
jh
jh
jh
jh
jh
jh
jh
jh
jh
jh
jh
jh
jh
jh
jh
jh
jh
jh
jh
jh
jh
jh
jh
jh
jh
"}
(47,1,1) = {"
jh
jh
jh
jh
jh
jh
jh
jh
jh
jh
jh
jh
jh
jh
jh
jh
jh
jh
jh
jh
jh
jh
jh
jh
jh
jh
jh
jh
jh
jh
jh
jh
jh
jh
jh
jh
jh
jh
jh
jh
jh
jh
jh
jh
jh
jh
jh
jh
jh
jh
jh
jh
jh
jh
jh
jh
jh
jh
jh
jh
"}
(48,1,1) = {"
jh
jh
jh
jh
jh
jh
jh
jh
jh
jh
jh
jh
jh
jh
jh
jh
jh
jh
jh
jh
jh
jh
jh
jh
jh
jh
jh
jh
jh
jh
jh
jh
jh
jh
jh
jh
jh
jh
jh
jh
jh
jh
jh
jh
jh
jh
jh
jh
jh
jh
jh
jh
jh
jh
jh
jh
jh
jh
jh
jh
"}
(49,1,1) = {"
jh
jh
jh
jh
jh
jh
jh
jh
jh
jh
jh
jh
jh
jh
jh
jh
jh
jh
jh
jh
jh
jh
jh
jh
jh
jh
jh
jh
jh
jh
jh
jh
jh
jh
jh
jh
jh
jh
jh
jh
jh
jh
jh
jh
jh
jh
jh
jh
jh
jh
jh
jh
jh
jh
jh
jh
jh
jh
jh
jh
"}
(50,1,1) = {"
jh
jh
jh
jh
jh
jh
jh
jh
jh
jh
jh
jh
jh
jh
jh
jh
jh
jh
jh
jh
jh
jh
jh
jh
jh
jh
jh
jh
jh
jh
jh
jh
jh
jh
jh
jh
jh
jh
jh
jh
jh
jh
jh
jh
jh
jh
jh
jh
jh
jh
jh
jh
jh
jh
jh
jh
jh
jh
jh
jh
"}
(51,1,1) = {"
jh
jh
jh
jh
jh
jh
jh
jh
jh
jh
jh
jh
jh
jh
jh
jh
jh
jh
jh
jh
jh
jh
jh
jh
jh
jh
jh
jh
jh
jh
jh
jh
jh
jh
jh
jh
jh
jh
jh
jh
jh
jh
jh
jh
jh
jh
jh
jh
jh
jh
jh
jh
jh
jh
jh
jh
jh
jh
jh
jh
"}
(52,1,1) = {"
jh
jh
jh
jh
jh
jh
jh
jh
jh
jh
jh
jh
jh
jh
jh
jh
jh
jh
jh
jh
jh
jh
jh
jh
jh
jh
jh
jh
jh
jh
jh
jh
jh
jh
jh
jh
jh
jh
jh
jh
jh
jh
jh
jh
jh
jh
jh
jh
jh
jh
jh
jh
jh
jh
jh
jh
jh
jh
jh
jh
"}
(53,1,1) = {"
jh
jh
jh
jh
jh
jh
jh
jh
jh
jh
jh
jh
jh
jh
jh
jh
jh
jh
jh
jh
jh
jh
jh
jh
jh
jh
jh
jh
jh
jh
jh
jh
jh
jh
jh
jh
jh
jh
jh
jh
jh
jh
jh
jh
jh
jh
jh
jh
jh
jh
jh
jh
jh
jh
jh
jh
jh
jh
jh
jh
"}
(54,1,1) = {"
jh
jh
jh
jh
jh
jh
jh
jh
jh
jh
jh
jh
jh
jh
jh
jh
jh
jh
jh
jh
jh
jh
jh
jh
jh
jh
jh
jh
jh
jh
jh
jh
jh
jh
jh
jh
jh
jh
jh
jh
jh
jh
jh
jh
jh
jh
jh
jh
jh
jh
jh
jh
jh
jh
jh
jh
jh
jh
jh
jh
"}
(55,1,1) = {"
jh
jh
jh
jh
jh
jh
jh
jh
jh
jh
jh
jh
jh
jh
jh
jh
jh
jh
jh
jh
jh
jh
jh
jh
jh
jh
jh
jh
jh
jh
jh
jh
jh
jh
jh
jh
jh
jh
jh
jh
jh
jh
jh
jh
jh
jh
jh
jh
jh
jh
jh
jh
jh
jh
jh
jh
jh
jh
jh
jh
"}
(56,1,1) = {"
jh
jh
jh
jh
jh
jh
jh
jh
jh
jh
jh
jh
jh
jh
jh
jh
jh
jh
jh
jh
jh
jh
jh
jh
jh
jh
jh
jh
jh
jh
jh
jh
jh
jh
jh
jh
jh
jh
jh
jh
jh
jh
jh
jh
jh
jh
jh
jh
jh
jh
jh
jh
jh
jh
jh
jh
jh
jh
jh
jh
"}
(57,1,1) = {"
jh
jh
jh
jh
jh
jh
jh
jh
jh
jh
jh
jh
jh
jh
jh
jh
jh
jh
jh
jh
jh
jh
jh
jh
jh
jh
jh
jh
jh
jh
jh
jh
jh
jh
jh
jh
jh
jh
jh
jh
jh
jh
jh
jh
jh
jh
jh
jh
jh
jh
jh
jh
jh
jh
jh
jh
jh
jh
jh
jh
"}
(58,1,1) = {"
jh
jh
jh
jh
jh
jh
jh
jh
jh
jh
jh
jh
jh
jh
jh
jh
jh
jh
jh
jh
jh
jh
jh
jh
jh
jh
jh
jh
jh
jh
jh
jh
jh
jh
jh
jh
jh
jh
jh
jh
jh
jh
jh
jh
jh
jh
jh
jh
jh
jh
jh
jh
jh
jh
jh
jh
jh
jh
jh
jh
"}
(59,1,1) = {"
jh
jh
jh
jh
jh
jh
jh
jh
jh
jh
jh
jh
jh
jh
jh
jh
jh
jh
jh
jh
jh
jh
jh
jh
jh
jh
jh
jh
jh
jh
jh
jh
jh
jh
jh
jh
jh
jh
jh
jh
jh
jh
jh
jh
jh
jh
jh
jh
jh
jh
jh
jh
jh
jh
jh
jh
jh
jh
jh
jh
"}
(60,1,1) = {"
jh
jh
jh
jh
jh
jh
jh
jh
jh
jh
jh
jh
jh
jh
jh
jh
jh
jh
jh
jh
jh
jh
jh
jh
jh
jh
jh
jh
jh
jh
jh
jh
jh
jh
jh
jh
jh
jh
jh
jh
jh
jh
jh
jh
jh
jh
jh
jh
jh
jh
jh
jh
jh
jh
jh
jh
jh
jh
jh
jh
"}
