//MAP CONVERTED BY dmm2tgm.py THIS HEADER COMMENT PREVENTS RECONVERSION, DO NOT REMOVE
"bE" = (
/obj/abstract/map_data/example,
/turf/space,
/area/space)
"cd" = (
/obj/machinery/atmospherics/pipe/simple/hidden{
	dir = 4
	},
/obj/effect/floor_decal/industrial/warning/dust,
/turf/floor,
/area/example/third)
"cj" = (
/turf/open,
/area/turbolift/example/third)
"cw" = (
/obj/machinery/atmospherics/portables_connector,
/obj/machinery/portable_atmospherics/canister/empty,
/obj/effect/floor_decal/industrial/outline/red,
/turf/floor/tiled/dark/monotile,
/area/example/third)
"dx" = (
/obj/machinery/atmospherics/pipe/simple/hidden{
	dir = 5
	},
/obj/effect/floor_decal/industrial/warning/dust{
	dir = 10
	},
/turf/floor,
/area/example/third)
"eg" = (
/obj/machinery/light{
	dir = 8
	},
/obj/effect/floor_decal/industrial/warning/dust{
	dir = 4
	},
/turf/floor/tiled/steel_grid,
/area/example/third)
"eD" = (
/obj/machinery/atmospherics/pipe/simple/hidden{
	dir = 6
	},
/obj/effect/floor_decal/industrial/warning/dust{
	dir = 8
	},
/turf/floor,
/area/example/third)
"hv" = (
/obj/machinery/alarm{
	dir = 1;
	pixel_y = -21
	},
/turf/floor,
/area/example/third)
"iI" = (
/obj/effect/floor_decal/industrial/warning/dust{
	dir = 9
	},
/turf/floor/tiled/steel_grid,
/area/example/third)
"jb" = (
/obj/machinery/light,
/turf/open,
/area/example/third)
"lK" = (
/turf/floor/glass,
/area/example/third)
"lY" = (
/obj/machinery/atmospherics/unary/vent_pump/on,
/turf/floor,
/area/example/third)
"nG" = (
/turf/open,
/area/space)
"nN" = (
/obj/effect/floor_decal/industrial/warning/dust{
	dir = 8
	},
/turf/floor/tiled/steel_grid,
/area/example/third)
"pB" = (
/obj/effect/floor_decal/industrial/warning/dust,
/turf/floor/tiled/steel_grid,
/area/example/third)
"pH" = (
/obj/machinery/light{
	dir = 1
	},
/obj/effect/floor_decal/industrial/warning/dust{
	dir = 9
	},
/turf/floor/tiled/steel_grid,
/area/example/third)
"rX" = (
/obj/structure/railing/mapped{
	dir = 8
	},
/obj/machinery/atmospherics/pipe/simple/hidden,
/obj/effect/floor_decal/industrial/warning/dust{
	dir = 4
	},
/turf/floor,
/area/example/third)
"sH" = (
/obj/effect/wallframe_spawn/reinforced,
/turf/floor/plating,
/area/example/third)
"uC" = (
/obj/machinery/atmospherics/pipe/simple/hidden{
	dir = 5
	},
/obj/effect/floor_decal/industrial/warning/dust,
/turf/floor,
/area/example/third)
"uK" = (
/obj/machinery/atmospherics/pipe/simple/hidden{
	dir = 9
	},
/obj/effect/floor_decal/industrial/warning/dust{
	dir = 6
	},
/turf/floor,
/area/example/third)
"vo" = (
/obj/effect/floor_decal/industrial/warning/dust{
	dir = 5
	},
/turf/floor,
/area/example/third)
"ww" = (
/obj/machinery/light{
	dir = 8
	},
/turf/open,
/area/example/third)
"wD" = (
/obj/effect/floor_decal/industrial/warning/dust{
	dir = 4
	},
/turf/floor/tiled/steel_grid,
/area/example/third)
"xk" = (
/turf/space,
/area/space)
"xD" = (
/obj/machinery/atmospherics/pipe/manifold/hidden,
/obj/effect/floor_decal/industrial/warning/dust,
/turf/floor,
/area/example/third)
"yv" = (
/obj/effect/floor_decal/industrial/warning/dust{
	dir = 9
	},
/turf/floor,
/area/example/third)
"Al" = (
/obj/machinery/atmospherics/pipe/simple/hidden,
/obj/effect/floor_decal/industrial/warning/dust{
	dir = 8
	},
/turf/floor,
/area/example/third)
"AD" = (
/turf/floor/tiled/steel_grid,
/area/example/third)
"Em" = (
/obj/machinery/atmospherics/pipe/simple/hidden{
	dir = 10
	},
/obj/effect/floor_decal/industrial/warning/dust{
	dir = 4
	},
/turf/floor,
/area/example/third)
"Es" = (
/turf/floor,
/area/example/third)
"EO" = (
/obj/structure/railing/mapped{
	dir = 1
	},
/turf/floor,
/area/example/third)
"Ff" = (
/obj/machinery/atmospherics/portables_connector,
/obj/machinery/portable_atmospherics/canister/air,
/obj/effect/floor_decal/industrial/outline/blue,
/turf/floor/tiled/dark/monotile,
/area/example/third)
"Fk" = (
/obj/machinery/light{
	dir = 1
	},
/obj/effect/floor_decal/industrial/warning/dust{
	dir = 5
	},
/turf/floor/tiled/steel_grid,
/area/example/third)
"GA" = (
/obj/machinery/power/debug_items/infinite_generator,
/obj/structure/cable/yellow{
	icon_state = "0-2"
	},
/turf/floor,
/area/example/third)
"HC" = (
/obj/effect/floor_decal/industrial/warning/dust,
/turf/floor,
/area/example/third)
"Ke" = (
/turf/open,
/area/example/third)
"KS" = (
/obj/effect/floor_decal/industrial/warning/dust{
	dir = 1
	},
/turf/floor/tiled/steel_grid,
/area/example/third)
"LP" = (
/turf/wall/r_wall/prepainted,
/area/example/third)
"MG" = (
/obj/structure/cable/yellow{
	icon_state = "1-4"
	},
/turf/floor,
/area/example/third)
"MO" = (
/obj/abstract/level_data_spawner/main_level{
	name = "Example Third Deck";
	
	},
/turf/space,
/area/space)
"Nz" = (
/obj/machinery/atmospherics/pipe/simple/hidden{
	dir = 9
	},
/obj/effect/floor_decal/industrial/warning/dust,
/turf/floor,
/area/example/third)
"NO" = (
/obj/machinery/light,
/turf/floor,
/area/example/third)
"NP" = (
/obj/effect/floor_decal/industrial/warning/dust{
	dir = 1
	},
/turf/floor,
/area/example/third)
"OJ" = (
/obj/machinery/door/airlock/external/glass,
/turf/floor/tiled/steel_ridged,
/area/example/third)
"Qg" = (
/obj/machinery/light{
	dir = 1
	},
/turf/floor,
/area/example/third)
"QH" = (
/obj/machinery/power/apc{
	dir = 1;
	pixel_y = 21
	},
/obj/structure/cable/yellow{
	icon_state = "0-8"
	},
/obj/machinery/light_switch/on{
	pixel_x = 11;
	pixel_y = 31
	},
/turf/floor,
/area/example/third)
"TM" = (
/obj/structure/catwalk,
/turf/open,
/area/example/third)
"TO" = (
/obj/machinery/atmospherics/pipe/simple/hidden,
/obj/effect/floor_decal/industrial/warning/dust{
	dir = 4
	},
/turf/floor,
/area/example/third)
"UC" = (
/obj/structure/ladder,
/turf/open,
/area/example/third)
"UM" = (
/obj/machinery/atmospherics/unary/vent_scrubber/on{
	dir = 8
	},
/turf/floor,
/area/example/third)
"UV" = (
/obj/machinery/light{
	dir = 4
	},
/turf/floor/tiled/steel_grid,
/area/example/third)
"Wn" = (
/obj/machinery/atmospherics/unary/vent_scrubber/on,
/turf/floor,
/area/example/third)
"WU" = (
/obj/effect/floor_decal/industrial/warning/dust{
	dir = 6
	},
/turf/floor/tiled/steel_grid,
/area/example/third)
"Xg" = (
/obj/structure/railing/mapped{
	dir = 4
	},
/turf/floor,
/area/example/third)
"Ye" = (
/obj/machinery/atmospherics/unary/vent_pump/on{
	dir = 4
	},
/turf/floor,
/area/example/third)
"Zr" = (
/obj/effect/floor_decal/industrial/warning/dust/corner{
	dir = 1
	},
/obj/effect/floor_decal/industrial/warning/dust/corner{
	dir = 4
	},
/turf/floor/tiled/steel_grid,
/area/example/third)

(1,1,1) = {"
xk
xk
xk
xk
xk
xk
xk
xk
xk
xk
xk
xk
xk
xk
xk
xk
xk
xk
xk
xk
xk
xk
xk
xk
xk
xk
xk
xk
xk
xk
xk
xk
xk
xk
xk
xk
xk
xk
xk
xk
xk
xk
xk
xk
xk
xk
xk
xk
xk
xk
xk
MO
"}
(2,1,1) = {"
xk
xk
xk
xk
xk
xk
xk
xk
xk
xk
xk
xk
xk
xk
xk
xk
xk
xk
xk
xk
xk
xk
xk
xk
xk
xk
xk
xk
xk
xk
xk
xk
xk
xk
xk
xk
xk
xk
xk
xk
xk
xk
xk
xk
xk
xk
xk
xk
xk
xk
xk
bE
"}
(3,1,1) = {"
xk
xk
xk
xk
xk
xk
xk
xk
xk
xk
xk
xk
xk
xk
xk
xk
xk
xk
xk
xk
xk
xk
xk
xk
xk
xk
xk
xk
xk
xk
xk
xk
xk
xk
xk
xk
xk
xk
xk
xk
xk
xk
xk
xk
xk
xk
xk
xk
xk
xk
xk
xk
"}
(4,1,1) = {"
xk
xk
xk
xk
xk
xk
xk
xk
xk
xk
xk
xk
xk
xk
xk
xk
xk
xk
xk
xk
xk
xk
xk
xk
xk
xk
xk
xk
xk
xk
xk
xk
xk
xk
xk
xk
xk
xk
xk
xk
xk
xk
xk
xk
xk
xk
xk
xk
xk
xk
xk
xk
"}
(5,1,1) = {"
xk
xk
xk
xk
xk
xk
xk
xk
xk
xk
xk
xk
xk
xk
xk
xk
xk
xk
xk
xk
xk
xk
xk
xk
xk
xk
xk
xk
xk
xk
xk
xk
xk
xk
xk
xk
xk
xk
xk
xk
xk
xk
xk
xk
xk
xk
xk
xk
xk
xk
xk
xk
"}
(6,1,1) = {"
xk
xk
xk
xk
xk
xk
xk
xk
xk
xk
xk
xk
xk
xk
xk
xk
xk
xk
xk
xk
xk
xk
xk
xk
xk
xk
xk
xk
xk
xk
xk
xk
xk
xk
xk
xk
xk
xk
xk
xk
xk
xk
xk
xk
xk
xk
xk
xk
xk
xk
xk
xk
"}
(7,1,1) = {"
xk
xk
xk
xk
xk
xk
xk
xk
xk
xk
xk
xk
xk
xk
xk
xk
xk
xk
xk
xk
xk
xk
xk
xk
xk
xk
xk
xk
xk
xk
xk
xk
xk
xk
xk
xk
xk
xk
xk
xk
xk
xk
xk
xk
xk
xk
xk
xk
xk
xk
xk
xk
"}
(8,1,1) = {"
xk
xk
xk
xk
xk
xk
xk
xk
xk
xk
xk
xk
xk
xk
xk
xk
xk
xk
xk
xk
xk
xk
xk
xk
xk
xk
xk
xk
xk
xk
xk
xk
xk
xk
xk
xk
xk
xk
xk
xk
xk
xk
xk
xk
xk
xk
xk
xk
xk
xk
xk
xk
"}
(9,1,1) = {"
xk
xk
xk
xk
xk
xk
xk
xk
nG
nG
nG
nG
nG
nG
nG
nG
nG
nG
nG
nG
nG
nG
nG
nG
nG
nG
nG
nG
nG
nG
nG
nG
nG
nG
nG
nG
nG
nG
nG
nG
nG
nG
nG
nG
xk
xk
xk
xk
xk
xk
xk
xk
"}
(10,1,1) = {"
xk
xk
xk
xk
xk
xk
xk
xk
nG
nG
nG
nG
nG
nG
nG
nG
nG
nG
nG
nG
nG
nG
nG
nG
nG
nG
nG
nG
nG
nG
nG
nG
nG
nG
nG
nG
nG
nG
nG
nG
nG
nG
nG
nG
xk
xk
xk
xk
xk
xk
xk
xk
"}
(11,1,1) = {"
xk
xk
xk
xk
xk
xk
xk
xk
nG
nG
LP
LP
LP
LP
LP
LP
LP
LP
LP
LP
LP
LP
LP
LP
LP
LP
LP
LP
LP
LP
LP
LP
LP
LP
LP
LP
LP
LP
LP
LP
LP
LP
nG
nG
xk
xk
xk
xk
xk
xk
xk
xk
"}
(12,1,1) = {"
xk
xk
xk
xk
xk
xk
xk
xk
nG
nG
LP
Ke
Ke
Ke
Ke
Ke
Ke
Ke
Ke
Ke
Ke
Ke
Ke
Ke
Ke
Ke
Ke
Ke
Ke
Ke
Ke
Ke
ww
Ke
Ke
Ke
Ke
Ke
Ke
Ke
Ke
LP
nG
nG
xk
xk
xk
xk
xk
xk
xk
xk
"}
(13,1,1) = {"
xk
xk
xk
xk
xk
xk
xk
xk
nG
nG
LP
Ke
Ke
Ke
Ke
Ke
Ke
Ke
Ke
Ke
Ke
Ke
Ke
Ke
Ke
Ke
Ke
Ke
Ke
Ke
Ke
Ke
Ke
Ke
Ke
Ke
Ke
Ke
Ke
Ke
Ke
LP
nG
nG
xk
xk
xk
xk
xk
xk
xk
xk
"}
(14,1,1) = {"
xk
xk
xk
xk
xk
xk
xk
xk
nG
nG
LP
Ke
Ke
Ke
Ke
Ke
Ke
Ke
Ke
Ke
Ke
Ke
Ke
Ke
Ke
Ke
Ke
Ke
Ke
Ke
Ke
Ke
Ke
Ke
Ke
Ke
Ke
Ke
Ke
Ke
Ke
LP
nG
nG
xk
xk
xk
xk
xk
xk
xk
xk
"}
(15,1,1) = {"
xk
xk
xk
xk
xk
xk
xk
xk
nG
nG
LP
Ke
Ke
Ke
Ke
Ke
Ke
Ke
Ke
Ke
Ke
Ke
Ke
Ke
Ke
Ke
Ke
Ke
yv
eD
Al
Al
Al
Al
Al
Al
Al
dx
Ke
Ke
Ke
LP
nG
nG
xk
xk
xk
xk
xk
xk
xk
xk
"}
(16,1,1) = {"
xk
xk
xk
xk
xk
xk
xk
xk
nG
nG
LP
Ke
Ke
Ke
Ke
Ke
Ke
Ke
Ke
Ke
Ke
Ke
Ke
Ke
Ke
Ke
Ke
Ke
NP
UM
Es
Es
Es
Es
Es
Es
Wn
xD
Ke
Ke
Ke
LP
nG
nG
xk
xk
xk
xk
xk
xk
xk
xk
"}
(17,1,1) = {"
xk
xk
xk
xk
xk
xk
xk
xk
nG
nG
LP
Ke
Ke
Ke
Ke
Ke
Ke
Ke
Ke
Ke
Ke
Ke
Ke
Ke
Ke
Ke
Ke
Ke
NP
Es
Es
Es
Es
Es
Es
Es
Es
cd
Ke
Ke
Ke
LP
nG
nG
xk
xk
xk
xk
xk
xk
xk
xk
"}
(18,1,1) = {"
xk
xk
xk
xk
xk
xk
xk
xk
nG
nG
LP
Ke
Ke
Ke
Ke
Ke
Ke
Ke
Ke
Ke
Ke
Ke
Ke
Ke
Ke
Ke
Ke
Ke
NP
GA
MG
Es
Es
Es
Es
Es
cw
Nz
Ke
Ke
Ke
LP
nG
nG
xk
xk
xk
xk
xk
xk
xk
xk
"}
(19,1,1) = {"
xk
xk
xk
xk
xk
xk
xk
xk
nG
nG
LP
LP
LP
LP
LP
LP
LP
LP
LP
pH
nN
nN
nN
nN
nN
nN
nN
nN
NP
LP
QH
Es
Es
Es
Es
hv
LP
HC
Ke
Ke
Ke
LP
nG
nG
xk
xk
xk
xk
xk
xk
xk
xk
"}
(20,1,1) = {"
xk
xk
xk
xk
xk
xk
xk
xk
nG
nG
LP
lK
lK
lK
lK
lK
lK
lK
sH
KS
AD
AD
AD
AD
AD
AD
AD
AD
NP
LP
Qg
Es
Es
Es
Es
NO
LP
HC
Ke
Ke
jb
LP
nG
nG
xk
xk
xk
xk
xk
xk
xk
xk
"}
(21,1,1) = {"
xk
xk
xk
xk
xk
xk
xk
xk
nG
nG
LP
lK
lK
lK
lK
lK
lK
lK
sH
KS
AD
AD
AD
AD
AD
AD
AD
AD
NP
Es
Es
Es
Es
Es
Es
Es
Ff
uC
Ke
Ke
Ke
LP
nG
nG
xk
xk
xk
xk
xk
xk
xk
xk
"}
(22,1,1) = {"
xk
xk
xk
xk
xk
xk
xk
xk
nG
nG
LP
lK
lK
lK
lK
lK
lK
lK
sH
KS
AD
AD
AD
AD
AD
AD
AD
AD
NP
Es
Es
Xg
Es
Es
Es
Es
Es
cd
Ke
Ke
Ke
LP
nG
nG
xk
xk
xk
xk
xk
xk
xk
xk
"}
(23,1,1) = {"
xk
xk
xk
xk
xk
xk
xk
xk
nG
nG
LP
lK
lK
lK
lK
lK
lK
lK
sH
KS
AD
AD
AD
AD
AD
AD
AD
AD
NP
Ye
Es
Ke
EO
Es
Es
Es
lY
xD
Ke
Ke
Ke
LP
nG
nG
xk
xk
xk
xk
xk
xk
xk
xk
"}
(24,1,1) = {"
xk
xk
xk
xk
xk
xk
xk
xk
nG
nG
LP
lK
lK
lK
lK
lK
lK
lK
sH
KS
AD
AD
AD
AD
AD
AD
AD
AD
vo
Em
TO
rX
TO
TO
TO
TO
TO
uK
Ke
Ke
Ke
LP
nG
nG
xk
xk
xk
xk
xk
xk
xk
xk
"}
(25,1,1) = {"
xk
xk
xk
xk
xk
xk
xk
xk
nG
nG
LP
lK
lK
lK
lK
lK
lK
lK
sH
KS
AD
AD
AD
AD
AD
AD
UV
AD
AD
pB
Ke
Ke
Ke
Ke
Ke
Ke
Ke
Ke
Ke
Ke
Ke
LP
nG
nG
xk
xk
xk
xk
xk
xk
xk
xk
"}
(26,1,1) = {"
xk
xk
xk
xk
xk
xk
xk
xk
nG
nG
LP
lK
lK
lK
lK
lK
lK
iI
OJ
Zr
AD
AD
AD
AD
AD
AD
LP
UC
AD
pB
Ke
Ke
Ke
Ke
Ke
Ke
Ke
Ke
Ke
Ke
Ke
LP
nG
nG
xk
xk
xk
xk
xk
xk
xk
xk
"}
(27,1,1) = {"
xk
xk
xk
xk
xk
xk
xk
xk
nG
nG
LP
LP
LP
LP
LP
LP
LP
LP
LP
Fk
wD
wD
wD
wD
wD
wD
eg
wD
wD
WU
Ke
Ke
Ke
Ke
Ke
Ke
Ke
Ke
Ke
Ke
Ke
LP
nG
nG
xk
xk
xk
xk
xk
xk
xk
xk
"}
(28,1,1) = {"
xk
xk
xk
xk
xk
xk
xk
xk
nG
nG
LP
Ke
Ke
Ke
Ke
Ke
Ke
Ke
Ke
Ke
Ke
Ke
Ke
Ke
Ke
Ke
Ke
TM
TM
TM
Ke
Ke
Ke
Ke
Ke
Ke
Ke
Ke
Ke
Ke
Ke
LP
nG
nG
xk
xk
xk
xk
xk
xk
xk
xk
"}
(29,1,1) = {"
xk
xk
xk
xk
xk
xk
xk
xk
nG
nG
LP
Ke
Ke
Ke
Ke
Ke
Ke
Ke
Ke
Ke
Ke
Ke
Ke
Ke
Ke
Ke
Ke
TM
TM
TM
Ke
Ke
Ke
Ke
Ke
Ke
Ke
Ke
Ke
Ke
Ke
LP
nG
nG
xk
xk
xk
xk
xk
xk
xk
xk
"}
(30,1,1) = {"
xk
xk
xk
xk
xk
xk
xk
xk
nG
nG
LP
Ke
Ke
Ke
Ke
Ke
Ke
Ke
Ke
Ke
Ke
Ke
Ke
Ke
Ke
Ke
Ke
TM
TM
TM
Ke
Ke
Ke
Ke
Ke
Ke
Ke
Ke
Ke
Ke
Ke
LP
nG
nG
xk
xk
xk
xk
xk
xk
xk
xk
"}
(31,1,1) = {"
xk
xk
xk
xk
xk
xk
xk
xk
nG
nG
LP
Ke
Ke
Ke
Ke
Ke
Ke
Ke
Ke
Ke
Ke
Ke
Ke
Ke
Ke
Ke
Ke
TM
TM
TM
Ke
Ke
Ke
Ke
Ke
Ke
Ke
Ke
Ke
Ke
Ke
LP
nG
nG
xk
xk
xk
xk
xk
xk
xk
xk
"}
(32,1,1) = {"
xk
xk
xk
xk
xk
xk
xk
xk
nG
nG
LP
Ke
Ke
Ke
Ke
Ke
Ke
Ke
Ke
Ke
Ke
Ke
Ke
Ke
Ke
Ke
Ke
TM
TM
TM
Ke
Ke
Ke
Ke
Ke
Ke
Ke
Ke
Ke
Ke
Ke
LP
nG
nG
xk
xk
xk
xk
xk
xk
xk
xk
"}
(33,1,1) = {"
xk
xk
xk
xk
xk
xk
xk
xk
nG
nG
LP
Ke
Ke
Ke
Ke
Ke
Ke
Ke
Ke
Ke
Ke
Ke
Ke
Ke
Ke
Ke
Ke
TM
TM
TM
Ke
Ke
Ke
Ke
Ke
Ke
Ke
Ke
Ke
Ke
Ke
LP
nG
nG
xk
xk
xk
xk
xk
xk
xk
xk
"}
(34,1,1) = {"
xk
xk
xk
xk
xk
xk
xk
xk
nG
nG
LP
Ke
Ke
Ke
Ke
Ke
Ke
Ke
Ke
Ke
Ke
Ke
Ke
Ke
Ke
Ke
Ke
TM
TM
TM
Ke
Ke
Ke
Ke
Ke
Ke
Ke
Ke
Ke
Ke
Ke
LP
nG
nG
xk
xk
xk
xk
xk
xk
xk
xk
"}
(35,1,1) = {"
xk
xk
xk
xk
xk
xk
xk
xk
nG
nG
LP
Ke
Ke
Ke
Ke
Ke
Ke
Ke
Ke
Ke
Ke
Ke
Ke
Ke
Ke
Ke
TM
TM
TM
TM
TM
Ke
Ke
Ke
Ke
Ke
Ke
Ke
Ke
Ke
Ke
LP
nG
nG
xk
xk
xk
xk
xk
xk
xk
xk
"}
(36,1,1) = {"
xk
xk
xk
xk
xk
xk
xk
xk
nG
nG
LP
Ke
Ke
Ke
Ke
Ke
Ke
Ke
Ke
Ke
Ke
Ke
Ke
Ke
Ke
Ke
TM
cj
cj
cj
TM
Ke
Ke
Ke
Ke
Ke
Ke
Ke
Ke
Ke
Ke
LP
nG
nG
xk
xk
xk
xk
xk
xk
xk
xk
"}
(37,1,1) = {"
xk
xk
xk
xk
xk
xk
xk
xk
nG
nG
LP
Ke
Ke
Ke
Ke
Ke
Ke
Ke
Ke
Ke
Ke
Ke
Ke
Ke
Ke
Ke
TM
cj
cj
cj
TM
Ke
Ke
Ke
Ke
Ke
Ke
Ke
Ke
Ke
Ke
LP
nG
nG
xk
xk
xk
xk
xk
xk
xk
xk
"}
(38,1,1) = {"
xk
xk
xk
xk
xk
xk
xk
xk
nG
nG
LP
Ke
Ke
Ke
Ke
Ke
Ke
Ke
Ke
Ke
Ke
Ke
Ke
Ke
Ke
Ke
TM
cj
cj
cj
TM
Ke
Ke
Ke
Ke
Ke
Ke
Ke
Ke
Ke
Ke
LP
nG
nG
xk
xk
xk
xk
xk
xk
xk
xk
"}
(39,1,1) = {"
xk
xk
xk
xk
xk
xk
xk
xk
nG
nG
LP
Ke
Ke
Ke
Ke
Ke
Ke
Ke
Ke
Ke
Ke
Ke
Ke
Ke
Ke
Ke
TM
Ke
Ke
Ke
TM
Ke
Ke
Ke
Ke
Ke
Ke
Ke
Ke
Ke
Ke
LP
nG
nG
xk
xk
xk
xk
xk
xk
xk
xk
"}
(40,1,1) = {"
xk
xk
xk
xk
xk
xk
xk
xk
nG
nG
LP
Ke
Ke
Ke
Ke
Ke
Ke
Ke
Ke
Ke
Ke
Ke
Ke
Ke
Ke
Ke
TM
TM
TM
TM
TM
Ke
Ke
Ke
Ke
Ke
Ke
Ke
Ke
Ke
Ke
LP
nG
nG
xk
xk
xk
xk
xk
xk
xk
xk
"}
(41,1,1) = {"
xk
xk
xk
xk
xk
xk
xk
xk
nG
nG
LP
Ke
Ke
Ke
Ke
Ke
Ke
Ke
Ke
Ke
Ke
Ke
Ke
Ke
Ke
Ke
Ke
Ke
Ke
Ke
Ke
Ke
Ke
Ke
Ke
Ke
Ke
Ke
Ke
Ke
Ke
LP
nG
nG
xk
xk
xk
xk
xk
xk
xk
xk
"}
(42,1,1) = {"
xk
xk
xk
xk
xk
xk
xk
xk
nG
nG
LP
LP
LP
LP
LP
LP
LP
LP
LP
LP
LP
LP
LP
LP
LP
LP
LP
LP
LP
LP
LP
LP
LP
LP
LP
LP
LP
LP
LP
LP
LP
LP
nG
nG
xk
xk
xk
xk
xk
xk
xk
xk
"}
(43,1,1) = {"
xk
xk
xk
xk
xk
xk
xk
xk
nG
nG
nG
nG
nG
nG
nG
nG
nG
nG
nG
nG
nG
nG
nG
nG
nG
nG
nG
nG
nG
nG
nG
nG
nG
nG
nG
nG
nG
nG
nG
nG
nG
nG
nG
nG
xk
xk
xk
xk
xk
xk
xk
xk
"}
(44,1,1) = {"
xk
xk
xk
xk
xk
xk
xk
xk
nG
nG
nG
nG
nG
nG
nG
nG
nG
nG
nG
nG
nG
nG
nG
nG
nG
nG
nG
nG
nG
nG
nG
nG
nG
nG
nG
nG
nG
nG
nG
nG
nG
nG
nG
nG
xk
xk
xk
xk
xk
xk
xk
xk
"}
(45,1,1) = {"
xk
xk
xk
xk
xk
xk
xk
xk
xk
xk
xk
xk
xk
xk
xk
xk
xk
xk
xk
xk
xk
xk
xk
xk
xk
xk
xk
xk
xk
xk
xk
xk
xk
xk
xk
xk
xk
xk
xk
xk
xk
xk
xk
xk
xk
xk
xk
xk
xk
xk
xk
xk
"}
(46,1,1) = {"
xk
xk
xk
xk
xk
xk
xk
xk
xk
xk
xk
xk
xk
xk
xk
xk
xk
xk
xk
xk
xk
xk
xk
xk
xk
xk
xk
xk
xk
xk
xk
xk
xk
xk
xk
xk
xk
xk
xk
xk
xk
xk
xk
xk
xk
xk
xk
xk
xk
xk
xk
xk
"}
(47,1,1) = {"
xk
xk
xk
xk
xk
xk
xk
xk
xk
xk
xk
xk
xk
xk
xk
xk
xk
xk
xk
xk
xk
xk
xk
xk
xk
xk
xk
xk
xk
xk
xk
xk
xk
xk
xk
xk
xk
xk
xk
xk
xk
xk
xk
xk
xk
xk
xk
xk
xk
xk
xk
xk
"}
(48,1,1) = {"
xk
xk
xk
xk
xk
xk
xk
xk
xk
xk
xk
xk
xk
xk
xk
xk
xk
xk
xk
xk
xk
xk
xk
xk
xk
xk
xk
xk
xk
xk
xk
xk
xk
xk
xk
xk
xk
xk
xk
xk
xk
xk
xk
xk
xk
xk
xk
xk
xk
xk
xk
xk
"}
(49,1,1) = {"
xk
xk
xk
xk
xk
xk
xk
xk
xk
xk
xk
xk
xk
xk
xk
xk
xk
xk
xk
xk
xk
xk
xk
xk
xk
xk
xk
xk
xk
xk
xk
xk
xk
xk
xk
xk
xk
xk
xk
xk
xk
xk
xk
xk
xk
xk
xk
xk
xk
xk
xk
xk
"}
(50,1,1) = {"
xk
xk
xk
xk
xk
xk
xk
xk
xk
xk
xk
xk
xk
xk
xk
xk
xk
xk
xk
xk
xk
xk
xk
xk
xk
xk
xk
xk
xk
xk
xk
xk
xk
xk
xk
xk
xk
xk
xk
xk
xk
xk
xk
xk
xk
xk
xk
xk
xk
xk
xk
xk
"}
(51,1,1) = {"
xk
xk
xk
xk
xk
xk
xk
xk
xk
xk
xk
xk
xk
xk
xk
xk
xk
xk
xk
xk
xk
xk
xk
xk
xk
xk
xk
xk
xk
xk
xk
xk
xk
xk
xk
xk
xk
xk
xk
xk
xk
xk
xk
xk
xk
xk
xk
xk
xk
xk
xk
xk
"}
(52,1,1) = {"
xk
xk
xk
xk
xk
xk
xk
xk
xk
xk
xk
xk
xk
xk
xk
xk
xk
xk
xk
xk
xk
xk
xk
xk
xk
xk
xk
xk
xk
xk
xk
xk
xk
xk
xk
xk
xk
xk
xk
xk
xk
xk
xk
xk
xk
xk
xk
xk
xk
xk
xk
xk
"}
