//MAP CONVERTED BY dmm2tgm.py THIS HEADER COMMENT PREVENTS RECONVERSION, DO NOT REMOVE
"aa" = (
/turf/space,
/area/space)
"ab" = (
/turf/simulated/wall/r_wall,
/area/space)
"ac" = (
/turf/simulated/wall,
/area/surgery)
"ad" = (
/obj/structure/iv_drip,
/obj/item/chems/ivbag/blood/OMinus,
/obj/item/chems/ivbag/blood/OMinus,
/obj/item/chems/ivbag/blood/OMinus,
/obj/effect/floor_decal/corner/blue/mono,
/turf/simulated/floor/tiled/white/monotile,
/area/surgery)
"ae" = (
/obj/machinery/optable,
/obj/effect/floor_decal/corner/blue/mono,
/turf/simulated/floor/tiled/white/monotile,
/area/surgery)
"af" = (
/obj/machinery/computer/operating,
/obj/effect/floor_decal/corner/blue/mono,
/turf/simulated/floor/tiled/white/monotile,
/area/surgery)
"ag" = (
/obj/structure/table/glass,
/obj/item/storage/box/syringes,
/obj/item/storage/box/freezer,
/obj/machinery/light/spot{
	dir = 1
	},
/obj/effect/floor_decal/corner/blue/mono,
/turf/simulated/floor/tiled/white/monotile,
/area/surgery)
"ah" = (
/obj/structure/table/glass,
/obj/item/storage/box/gloves,
/obj/item/storage/box/masks,
/obj/structure/railing/mapped{
	dir = 4
	},
/obj/effect/floor_decal/corner/blue/mono,
/turf/simulated/floor/tiled/white/monotile,
/area/surgery)
"ai" = (
/obj/machinery/atmospherics/unary/freezer,
/obj/effect/floor_decal/corner/blue/mono,
/turf/simulated/floor/tiled/white/monotile,
/area/surgery)
"aj" = (
/obj/structure/lattice,
/turf/simulated/open,
/area/surgery)
"ak" = (
/obj/machinery/light/spot{
	dir = 1
	},
/obj/effect/floor_decal/corner/orange{
	dir = 5
	},
/obj/effect/floor_decal/industrial/warning{
	dir = 8
	},
/turf/simulated/floor/tiled/steel_grid,
/area/surgery)
"al" = (
/obj/structure/table/glass,
/obj/item/storage/firstaid/surgery,
/obj/effect/floor_decal/corner/blue/mono,
/turf/simulated/floor/tiled/white/monotile,
/area/surgery)
"am" = (
/obj/structure/railing/mapped{
	dir = 4
	},
/obj/effect/floor_decal/corner/blue{
	dir = 6
	},
/turf/simulated/floor/tiled/white,
/area/surgery)
"an" = (
/turf/simulated/open,
/area/surgery)
"ao" = (
/obj/structure/table/glass,
/obj/item/chems/dropper,
/obj/item/stack/nanopaste,
/obj/machinery/light/spot{
	dir = 8
	},
/obj/effect/floor_decal/corner/blue/mono,
/turf/simulated/floor/tiled/white/monotile,
/area/surgery)
"ap" = (
/obj/machinery/body_scanconsole{
	dir = 4
	},
/turf/simulated/floor/tiled/white,
/area/surgery)
"aq" = (
/obj/machinery/bodyscanner{
	dir = 4
	},
/turf/simulated/floor/tiled/white,
/area/surgery)
"ar" = (
/obj/machinery/sleeper/standard,
/obj/structure/railing/mapped{
	dir = 4
	},
/obj/effect/floor_decal/corner/blue{
	dir = 6
	},
/turf/simulated/floor/tiled/white,
/area/surgery)
"as" = (
/obj/machinery/light_switch/on{
	dir = 8;
	pixel_x = 24
	},
/obj/effect/floor_decal/corner/orange{
	dir = 6
	},
/turf/simulated/floor/tiled/steel_grid,
/area/surgery)
"at" = (
/obj/structure/table/glass,
/obj/item/scalpel/laser,
/obj/item/scalpel/laser/upgraded,
/obj/item/scalpel/laser/advanced,
/obj/item/robotanalyzer,
/obj/item/scanner/health,
/obj/item/storage/firstaid/adv,
/obj/effect/floor_decal/corner/blue/mono,
/turf/simulated/floor/tiled/white/monotile,
/area/surgery)
"au" = (
/obj/structure/ladder,
/obj/structure/railing/mapped{
	dir = 4
	},
/obj/effect/floor_decal/corner/blue{
	dir = 6
	},
/turf/simulated/floor/tiled/white,
/area/surgery)
"av" = (
/obj/machinery/atmospherics/portables_connector,
/obj/effect/floor_decal/corner/blue/mono,
/turf/simulated/floor/tiled/white/monotile,
/area/surgery)
"aw" = (
/obj/machinery/portable_atmospherics/canister/oxygen/prechilled,
/obj/machinery/atmospherics/portables_connector,
/obj/effect/floor_decal/corner/blue/mono,
/turf/simulated/floor/tiled/white/monotile,
/area/surgery)
"ay" = (
/obj/machinery/light/spot{
	dir = 4
	},
/obj/effect/floor_decal/corner/orange{
	dir = 6
	},
/turf/simulated/floor/tiled/steel_grid,
/area/surgery)
"az" = (
/obj/structure/closet/secure_closet/freezer/meat,
/obj/effect/floor_decal/corner/blue/mono,
/turf/simulated/floor/tiled/white/monotile,
/area/surgery)
"aB" = (
/obj/structure/hygiene/sink{
	dir = 8;
	pixel_x = -15
	},
/turf/simulated/floor/tiled/white,
/area/surgery)
"aC" = (
/obj/machinery/atmospherics/pipe/simple/hidden/blue{
	dir = 5
	},
/turf/simulated/floor/tiled/steel_grid,
/area/surgery)
"aD" = (
/obj/machinery/atmospherics/pipe/manifold/hidden/blue,
/turf/simulated/floor/tiled/steel_grid,
/area/surgery)
"aE" = (
/obj/machinery/atmospherics/unary/vent_pump/on,
/turf/simulated/floor/tiled/white,
/area/surgery)
"aF" = (
/obj/machinery/fabricator/bioprinter,
/obj/effect/floor_decal/corner/blue/mono,
/turf/simulated/floor/tiled/white/monotile,
/area/surgery)
"aG" = (
/obj/machinery/atmospherics/pipe/manifold/hidden,
/turf/simulated/floor/tiled/steel_grid,
/area/surgery)
"aH" = (
/obj/machinery/atmospherics/pipe/simple/hidden{
	dir = 4
	},
/turf/simulated/floor/tiled/steel_grid,
/area/surgery)
"aI" = (
/obj/machinery/atmospherics/portables_connector{
	dir = 8
	},
/obj/machinery/portable_atmospherics/canister/air,
/obj/effect/floor_decal/corner/orange/mono,
/turf/simulated/floor/tiled/monotile,
/area/surgery)
"aJ" = (
/obj/effect/floor_decal/corner/blue/three_quarters{
	dir = 4
	},
/turf/simulated/floor/tiled/white,
/area/surgery)
"aK" = (
/obj/machinery/atmospherics/pipe/simple/hidden/blue{
	dir = 9
	},
/obj/effect/floor_decal/corner/orange{
	dir = 6
	},
/turf/simulated/floor/tiled/steel_grid,
/area/surgery)
"aL" = (
/obj/machinery/atmospherics/pipe/manifold/hidden{
	dir = 1
	},
/turf/simulated/floor/tiled/steel_grid,
/area/surgery)
"aM" = (
/obj/machinery/atmospherics/portables_connector{
	dir = 8
	},
/obj/machinery/portable_atmospherics/canister/empty,
/obj/effect/floor_decal/corner/orange/mono,
/turf/simulated/floor/tiled/monotile,
/area/surgery)
"aO" = (
/obj/machinery/atmospherics/unary/vent_scrubber/on{
	dir = 1
	},
/turf/simulated/floor/tiled/steel_grid,
/area/surgery)
"aP" = (
/obj/machinery/light/spot{
	dir = 8
	},
/obj/machinery/design_database,
/obj/effect/floor_decal/corner/mauve/mono,
/turf/simulated/floor/tiled/white/monotile,
/area/surgery)
"aQ" = (
/obj/machinery/light/spot,
/obj/machinery/fabricator/protolathe,
/obj/effect/floor_decal/corner/mauve/mono,
/turf/simulated/floor/tiled/white/monotile,
/area/surgery)
"aR" = (
/obj/structure/cable{
	icon_state = "0-2"
	},
/obj/machinery/power/apc{
	dir = 8;
	name = "west bump";
	pixel_x = -24
	},
/obj/effect/floor_decal/corner/mauve{
	dir = 5
	},
/turf/simulated/floor/tiled/white,
/area/surgery)
"aS" = (
/obj/structure/cable{
	icon_state = "1-2"
	},
/turf/simulated/floor/tiled/white,
/area/surgery)
"aT" = (
/obj/structure/cable,
/obj/machinery/power/debug_items/infinite_generator,
/obj/effect/floor_decal/corner/mauve/mono,
/turf/simulated/floor/tiled/white/monotile,
/area/surgery)
"aU" = (
/obj/machinery/light/spot,
/obj/effect/floor_decal/corner/orange{
	dir = 10
	},
/turf/simulated/floor/tiled/steel_grid,
/area/surgery)
"aW" = (
/obj/machinery/fabricator/imprinter,
/obj/effect/floor_decal/corner/mauve/mono,
/turf/simulated/floor/tiled/white/monotile,
/area/surgery)
"aX" = (
/obj/machinery/destructive_analyzer,
/obj/effect/floor_decal/corner/mauve/mono,
/turf/simulated/floor/tiled/white/monotile,
/area/surgery)
"aZ" = (
/obj/effect/floor_decal/industrial/warning{
	dir = 8
	},
/turf/simulated/floor/tiled/steel_grid,
/area/surgery)
"ba" = (
/obj/machinery/fabricator/industrial,
/obj/effect/floor_decal/corner/mauve/mono,
/turf/simulated/floor/tiled/white/monotile,
/area/surgery)
"eY" = (
/obj/effect/floor_decal/corner/orange{
	dir = 10
	},
/turf/simulated/floor/tiled/steel_grid,
/area/surgery)
"hN" = (
/obj/machinery/atmospherics/pipe/simple/hidden{
	dir = 4
	},
/turf/simulated/floor/tiled/white,
/area/surgery)
"iE" = (
/obj/machinery/atmospherics/unary/vent_pump/on,
/turf/simulated/floor/tiled/steel_grid,
/area/surgery)
"kL" = (
/turf/simulated/floor/tiled/steel_grid,
/area/surgery)
"lr" = (
/obj/machinery/atmospherics/pipe/simple/hidden{
	dir = 6
	},
/turf/simulated/floor/tiled/steel_grid,
/area/surgery)
"qL" = (
/obj/machinery/computer/design_console,
/obj/effect/floor_decal/corner/mauve/mono,
/turf/simulated/floor/tiled/white/monotile,
/area/surgery)
"qY" = (
/obj/effect/floor_decal/corner/orange/mono,
/turf/simulated/floor/tiled/monotile,
/area/surgery)
"tL" = (
/obj/machinery/fabricator/robotics,
/obj/effect/floor_decal/corner/mauve/mono,
/turf/simulated/floor/tiled/white/monotile,
/area/surgery)
"zv" = (
/obj/machinery/atmospherics/pipe/simple/hidden{
	dir = 4
	},
/obj/effect/floor_decal/corner/blue{
	dir = 6
	},
/turf/simulated/floor/tiled/white,
/area/surgery)
"zS" = (
/obj/effect/floor_decal/corner/orange{
	dir = 6
	},
/turf/simulated/floor/tiled/steel_grid,
/area/surgery)
"Dg" = (
/obj/effect/floor_decal/industrial/warning{
	dir = 1
	},
/turf/simulated/floor/tiled/steel_grid,
/area/surgery)
"Em" = (
/turf/simulated/floor/tiled/white,
/area/surgery)
"FJ" = (
/obj/effect/floor_decal/corner/mauve/mono,
/turf/simulated/floor/tiled/white/monotile,
/area/surgery)
"HZ" = (
/obj/effect/floor_decal/industrial/warning/corner{
	dir = 1
	},
/turf/simulated/floor/tiled/steel_grid,
/area/surgery)
"KB" = (
/obj/effect/floor_decal/corner/blue{
	dir = 6
	},
/obj/effect/floor_decal/industrial/warning/corner{
	dir = 4
	},
/turf/simulated/floor/tiled/white,
/area/surgery)
"LO" = (
/obj/abstract/level_data/main_level,
/turf/space,
/area/space)
"Ry" = (
/obj/machinery/atmospherics/pipe/simple/hidden{
	dir = 5
	},
/turf/simulated/floor/tiled/white,
/area/surgery)
"SE" = (
/obj/effect/floor_decal/corner/blue{
	dir = 10
	},
/turf/simulated/floor/tiled/white,
/area/surgery)
"Tt" = (
/obj/machinery/design_database,
/obj/effect/floor_decal/corner/mauve/mono,
/turf/simulated/floor/tiled/white/monotile,
/area/surgery)
"Vl" = (
/obj/effect/floor_decal/corner/orange{
	dir = 9
	},
/turf/simulated/floor/tiled/steel_grid,
/area/surgery)
"WO" = (
/obj/structure/rack,
/obj/item/stack/material/reinforced/mapped/plasteel/fifty,
/obj/item/stack/material/ingot/mapped/copper/fifty,
/obj/item/stack/material/sheet/mapped/steel/fifty,
/obj/item/stack/material/pane/mapped/glass/fifty,
/obj/item/stack/material/reinforced/mapped/fiberglass/fifty,
/obj/item/stack/material/ingot/mapped/gold/ten,
/obj/item/stack/material/segment/mapped/mhydrogen/ten,
/obj/item/stack/material/ingot/mapped/silver/ten,
/obj/item/stack/material/puck/mapped/uranium/ten,
/obj/item/stack/material/gemstone/mapped/diamond/ten,
/obj/item/storage/belt/utility/full,
/obj/item/stack/material/sheet/mapped/steel/fifty,
/obj/machinery/light_switch/on{
	dir = 4;
	pixel_x = -24
	},
/obj/effect/floor_decal/corner/blue/mono,
/turf/simulated/floor/tiled/white/monotile,
/area/surgery)
"Zk" = (
/obj/effect/floor_decal/corner/mauve{
	dir = 5
	},
/turf/simulated/floor/tiled/white,
/area/surgery)

(1,1,1) = {"
aa
aa
aa
aa
aa
aa
aa
aa
aa
aa
aa
aa
aa
aa
aa
aa
aa
aa
aa
aa
aa
aa
aa
aa
aa
aa
aa
aa
aa
aa
aa
aa
"}
(2,1,1) = {"
aa
aa
aa
aa
aa
aa
aa
aa
aa
aa
aa
aa
aa
aa
aa
aa
aa
aa
aa
aa
aa
aa
aa
aa
aa
aa
aa
aa
aa
aa
aa
aa
"}
(3,1,1) = {"
aa
aa
aa
aa
aa
aa
aa
aa
aa
aa
aa
aa
aa
aa
aa
aa
aa
aa
aa
aa
aa
aa
aa
aa
aa
aa
aa
aa
aa
aa
aa
aa
"}
(4,1,1) = {"
aa
aa
aa
aa
aa
aa
aa
aa
aa
aa
aa
aa
aa
aa
aa
aa
aa
aa
aa
aa
aa
aa
aa
aa
aa
aa
aa
aa
aa
aa
aa
aa
"}
(5,1,1) = {"
aa
aa
aa
aa
aa
aa
aa
aa
aa
aa
aa
aa
aa
aa
aa
aa
aa
aa
aa
aa
aa
aa
aa
aa
aa
aa
aa
LO
aa
aa
aa
aa
"}
(6,1,1) = {"
aa
aa
aa
aa
aa
aa
aa
aa
aa
aa
aa
aa
aa
aa
aa
aa
aa
aa
aa
aa
aa
aa
aa
aa
aa
aa
aa
aa
aa
aa
aa
aa
"}
(7,1,1) = {"
aa
aa
aa
aa
aa
aa
aa
aa
aa
aa
aa
aa
aa
aa
aa
aa
aa
aa
aa
aa
aa
aa
aa
aa
aa
aa
aa
aa
aa
aa
aa
aa
"}
(8,1,1) = {"
aa
aa
aa
aa
aa
aa
aa
aa
aa
aa
aa
aa
aa
aa
aa
aa
aa
aa
aa
aa
aa
aa
aa
aa
aa
aa
aa
aa
aa
aa
aa
aa
"}
(9,1,1) = {"
aa
aa
aa
aa
aa
aa
aa
aa
aa
aa
aa
aa
aa
aa
aa
aa
aa
aa
aa
aa
aa
aa
aa
aa
aa
aa
aa
aa
aa
aa
aa
aa
"}
(10,1,1) = {"
aa
aa
aa
aa
aa
aa
aa
aa
aa
aa
aa
aa
aa
aa
aa
aa
aa
aa
aa
aa
aa
aa
aa
aa
aa
aa
aa
aa
aa
aa
aa
aa
"}
(11,1,1) = {"
aa
aa
aa
aa
aa
aa
aa
aa
aa
aa
aa
aa
aa
aa
aa
aa
aa
aa
aa
aa
aa
aa
aa
aa
aa
aa
aa
aa
aa
aa
aa
aa
"}
(12,1,1) = {"
aa
aa
aa
aa
aa
aa
aa
aa
aa
aa
aa
aa
aa
aa
aa
aa
aa
aa
aa
aa
aa
aa
aa
aa
aa
aa
aa
aa
aa
aa
aa
aa
"}
(13,1,1) = {"
aa
aa
aa
aa
aa
aa
aa
aa
aa
aa
aa
aa
aa
aa
aa
aa
aa
aa
aa
aa
aa
aa
aa
aa
aa
aa
aa
aa
aa
aa
aa
aa
"}
(14,1,1) = {"
aa
aa
aa
aa
aa
aa
aa
aa
aa
aa
aa
aa
aa
aa
aa
aa
aa
aa
aa
aa
aa
aa
aa
aa
aa
aa
aa
aa
aa
aa
aa
aa
"}
(15,1,1) = {"
aa
aa
aa
aa
aa
aa
aa
aa
aa
aa
aa
aa
aa
aa
aa
aa
aa
aa
aa
aa
aa
aa
aa
aa
aa
aa
aa
aa
aa
aa
aa
aa
"}
(16,1,1) = {"
aa
aa
aa
aa
aa
aa
aa
ab
ab
ab
ab
ab
ab
ab
ab
ab
ab
ab
ab
ab
ab
ab
ab
ab
ab
ab
aa
aa
aa
aa
aa
aa
"}
(17,1,1) = {"
aa
aa
aa
aa
aa
aa
aa
ab
ab
ab
ab
ab
ab
ab
ab
ab
ab
ab
ab
ab
ab
ab
ab
ab
ab
ab
aa
aa
aa
aa
aa
aa
"}
(18,1,1) = {"
aa
aa
aa
aa
aa
aa
aa
ab
ab
ac
ac
ac
ac
ac
ac
ac
ac
ac
ac
ac
ac
ac
ac
ac
ab
ab
aa
aa
aa
aa
aa
aa
"}
(19,1,1) = {"
aa
aa
aa
aa
aa
aa
aa
ab
ab
ac
ad
al
ao
at
az
aF
WO
Vl
Vl
aP
aR
aS
aT
ac
ab
ab
aa
aa
aa
aa
aa
aa
"}
(20,1,1) = {"
aa
aa
aa
aa
aa
aa
aa
ab
ab
ac
ae
aB
ap
Em
Em
Em
SE
kL
kL
Tt
Zk
Em
aW
ac
ab
ab
aa
aa
aa
aa
aa
aa
"}
(21,1,1) = {"
aa
aa
aa
aa
aa
aa
aa
ab
ab
ac
af
Em
aq
Em
aE
Ry
SE
lr
aO
qL
Zk
Em
aX
ac
ab
ab
aa
aa
aa
aa
aa
aa
"}
(22,1,1) = {"
aa
aa
aa
aa
aa
aa
aa
ab
ab
ac
ag
Em
Em
Em
Em
hN
SE
aH
kL
Em
Em
Em
aQ
ac
ab
ab
aa
aa
aa
aa
aa
aa
"}
(23,1,1) = {"
aa
aa
aa
aa
aa
aa
aa
ab
ab
ac
ah
am
ar
au
KB
zv
aJ
aH
kL
tL
Zk
Em
ba
ac
ab
ab
aa
aa
aa
aa
aa
aa
"}
(24,1,1) = {"
aa
aa
aa
aa
aa
aa
aa
ab
ab
ac
aj
an
an
an
Dg
aH
kL
aH
kL
tL
Zk
Em
FJ
ac
ab
ab
aa
aa
aa
aa
aa
aa
"}
(25,1,1) = {"
aa
aa
aa
aa
aa
aa
aa
ab
ab
ac
aj
an
an
an
Dg
aH
kL
aH
kL
kL
kL
kL
eY
ac
ab
ab
aa
aa
aa
aa
aa
aa
"}
(26,1,1) = {"
aa
aa
aa
aa
aa
aa
aa
ab
ab
ac
aj
an
an
an
Dg
aH
kL
aH
kL
kL
kL
kL
eY
ac
ab
ab
aa
aa
aa
aa
aa
aa
"}
(27,1,1) = {"
aa
aa
aa
aa
aa
aa
aa
ab
ab
ac
aj
an
an
an
Dg
aH
kL
aH
kL
kL
kL
kL
eY
ac
ab
ab
aa
aa
aa
aa
aa
aa
"}
(28,1,1) = {"
aa
aa
aa
aa
aa
aa
aa
ab
ab
ac
ak
aZ
aZ
aZ
HZ
aH
kL
aH
kL
kL
kL
kL
aU
ac
ab
ab
aa
aa
aa
aa
aa
aa
"}
(29,1,1) = {"
aa
aa
aa
aa
aa
aa
aa
ab
ab
ac
ai
aC
kL
kL
iE
aG
kL
aL
aO
kL
kL
kL
eY
ac
ab
ab
aa
aa
aa
aa
aa
aa
"}
(30,1,1) = {"
aa
aa
aa
aa
aa
aa
aa
ab
ab
ac
av
aD
kL
kL
kL
aH
kL
aH
kL
kL
kL
kL
eY
ac
ab
ab
aa
aa
aa
aa
aa
aa
"}
(31,1,1) = {"
aa
aa
aa
aa
aa
aa
aa
ab
ab
ac
aw
aK
as
ay
zS
aI
zS
aM
zS
zS
ay
zS
qY
ac
ab
ab
aa
aa
aa
aa
aa
aa
"}
(32,1,1) = {"
aa
aa
aa
aa
aa
aa
aa
ab
ab
ac
ac
ac
ac
ac
ac
ac
ac
ac
ac
ac
ac
ac
ac
ac
ab
ab
aa
aa
aa
aa
aa
aa
"}
(33,1,1) = {"
aa
aa
aa
aa
aa
aa
aa
ab
ab
ab
ab
ab
ab
ab
ab
ab
ab
ab
ab
ab
ab
ab
ab
ab
ab
ab
aa
aa
aa
aa
aa
aa
"}
(34,1,1) = {"
aa
aa
aa
aa
aa
aa
aa
ab
ab
ab
ab
ab
ab
ab
ab
ab
ab
ab
ab
ab
ab
ab
ab
ab
ab
ab
aa
aa
aa
aa
aa
aa
"}
(35,1,1) = {"
aa
aa
aa
aa
aa
aa
aa
aa
aa
aa
aa
aa
aa
aa
aa
aa
aa
aa
aa
aa
aa
aa
aa
aa
aa
aa
aa
aa
aa
aa
aa
aa
"}
(36,1,1) = {"
aa
aa
aa
aa
aa
aa
aa
aa
aa
aa
aa
aa
aa
aa
aa
aa
aa
aa
aa
aa
aa
aa
aa
aa
aa
aa
aa
aa
aa
aa
aa
aa
"}
(37,1,1) = {"
aa
aa
aa
aa
aa
aa
aa
aa
aa
aa
aa
aa
aa
aa
aa
aa
aa
aa
aa
aa
aa
aa
aa
aa
aa
aa
aa
aa
aa
aa
aa
aa
"}
(38,1,1) = {"
aa
aa
aa
aa
aa
aa
aa
aa
aa
aa
aa
aa
aa
aa
aa
aa
aa
aa
aa
aa
aa
aa
aa
aa
aa
aa
aa
aa
aa
aa
aa
aa
"}
(39,1,1) = {"
aa
aa
aa
aa
aa
aa
aa
aa
aa
aa
aa
aa
aa
aa
aa
aa
aa
aa
aa
aa
aa
aa
aa
aa
aa
aa
aa
aa
aa
aa
aa
aa
"}
(40,1,1) = {"
aa
aa
aa
aa
aa
aa
aa
aa
aa
aa
aa
aa
aa
aa
aa
aa
aa
aa
aa
aa
aa
aa
aa
aa
aa
aa
aa
aa
aa
aa
aa
aa
"}
(41,1,1) = {"
aa
aa
aa
aa
aa
aa
aa
aa
aa
aa
aa
aa
aa
aa
aa
aa
aa
aa
aa
aa
aa
aa
aa
aa
aa
aa
aa
aa
aa
aa
aa
aa
"}
(42,1,1) = {"
aa
aa
aa
aa
aa
aa
aa
aa
aa
aa
aa
aa
aa
aa
aa
aa
aa
aa
aa
aa
aa
aa
aa
aa
aa
aa
aa
aa
aa
aa
aa
aa
"}
(43,1,1) = {"
aa
aa
aa
aa
aa
aa
aa
aa
aa
aa
aa
aa
aa
aa
aa
aa
aa
aa
aa
aa
aa
aa
aa
aa
aa
aa
aa
aa
aa
aa
aa
aa
"}
(44,1,1) = {"
aa
aa
aa
aa
aa
aa
aa
aa
aa
aa
aa
aa
aa
aa
aa
aa
aa
aa
aa
aa
aa
aa
aa
aa
aa
aa
aa
aa
aa
aa
aa
aa
"}
(45,1,1) = {"
aa
aa
aa
aa
aa
aa
aa
aa
aa
aa
aa
aa
aa
aa
aa
aa
aa
aa
aa
aa
aa
aa
aa
aa
aa
aa
aa
aa
aa
aa
aa
aa
"}
(46,1,1) = {"
aa
aa
aa
aa
aa
aa
aa
aa
aa
aa
aa
aa
aa
aa
aa
aa
aa
aa
aa
aa
aa
aa
aa
aa
aa
aa
aa
aa
aa
aa
aa
aa
"}
(47,1,1) = {"
aa
aa
aa
aa
aa
aa
aa
aa
aa
aa
aa
aa
aa
aa
aa
aa
aa
aa
aa
aa
aa
aa
aa
aa
aa
aa
aa
aa
aa
aa
aa
aa
"}
(48,1,1) = {"
aa
aa
aa
aa
aa
aa
aa
aa
aa
aa
aa
aa
aa
aa
aa
aa
aa
aa
aa
aa
aa
aa
aa
aa
aa
aa
aa
aa
aa
aa
aa
aa
"}
