//MAP CONVERTED BY dmm2tgm.py THIS HEADER COMMENT PREVENTS RECONVERSION, DO NOT REMOVE
"aa" = (
/turf/space,
/area/space)
"ab" = (
/obj/effect/landmark/map_data{
	height = 2
	},
/turf/space,
/area/space)
"ac" = (
/turf/simulated/wall,
/area/medical/surgery)
"ad" = (
/obj/effect/floor_decal/corner/blue/diagonal,
/obj/structure/iv_drip,
/obj/item/chems/ivbag/blood/OMinus,
/obj/item/chems/ivbag/blood/OMinus,
/obj/item/chems/ivbag/blood/OMinus,
/turf/simulated/floor/tiled/white,
/area/medical/surgery)
"ae" = (
/obj/effect/floor_decal/corner/blue/diagonal,
/obj/machinery/optable,
/turf/simulated/floor/tiled/white,
/area/medical/surgery)
"af" = (
/obj/effect/floor_decal/corner/blue/diagonal,
/obj/machinery/computer/operating,
/turf/simulated/floor/tiled/white,
/area/medical/surgery)
"ag" = (
/obj/effect/floor_decal/corner/blue/diagonal,
/obj/structure/table/glass,
/obj/item/storage/box/syringes,
/obj/item/storage/box/freezer,
/obj/machinery/light/spot{
	icon_state = "tube_map";
	dir = 1
	},
/turf/simulated/floor/tiled/white,
/area/medical/surgery)
"ah" = (
/obj/effect/floor_decal/corner/blue/diagonal,
/obj/structure/table/glass,
/obj/item/storage/box/gloves,
/obj/item/storage/box/masks,
/turf/simulated/floor/tiled/white,
/area/medical/surgery)
"ai" = (
/obj/effect/floor_decal/corner/blue/diagonal,
/obj/machinery/atmospherics/portables_connector,
/turf/simulated/floor/tiled/white,
/area/medical/surgery)
"aj" = (
/obj/structure/lattice,
/turf/simulated/open,
/area/medical/surgery)
"ak" = (
/obj/effect/floor_decal/corner/blue/diagonal,
/obj/machinery/light/spot{
	icon_state = "tube_map";
	dir = 1
	},
/turf/simulated/floor/tiled/white,
/area/medical/surgery)
"al" = (
/obj/effect/floor_decal/corner/blue/diagonal,
/obj/structure/table/glass,
/obj/item/storage/firstaid/surgery,
/turf/simulated/floor/tiled/white,
/area/medical/surgery)
"am" = (
/obj/effect/floor_decal/corner/blue/diagonal,
/obj/structure/hygiene/sink{
	icon_state = "sink";
	dir = 4
	},
/turf/simulated/floor/tiled/white,
/area/medical/surgery)
"an" = (
/turf/simulated/open,
/area/medical/surgery)
"ao" = (
/obj/effect/floor_decal/corner/blue/diagonal,
/obj/structure/table/glass,
/obj/item/chems/dropper,
/obj/item/stack/nanopaste,
/obj/machinery/light/spot{
	icon_state = "tube_map";
	dir = 8
	},
/turf/simulated/floor/tiled/white,
/area/medical/surgery)
"ap" = (
/obj/effect/floor_decal/corner/blue/diagonal,
/obj/machinery/body_scanconsole{
	icon_state = "body_scannerconsole";
	dir = 4
	},
/turf/simulated/floor/tiled/white,
/area/medical/surgery)
"aq" = (
/obj/effect/floor_decal/corner/blue/diagonal,
/obj/machinery/bodyscanner{
	icon_state = "body_scanner_0";
	dir = 4
	},
/turf/simulated/floor/tiled/white,
/area/medical/surgery)
"ar" = (
/obj/effect/floor_decal/corner/blue/diagonal,
/obj/machinery/sleeper/standard{
	icon_state = "sleeper_0";
	dir = 8
	},
/turf/simulated/floor/tiled/white,
/area/medical/surgery)
"as" = (
/obj/machinery/light_switch/on{
	pixel_x = 25
	},
/obj/effect/floor_decal/corner/blue/diagonal,
/turf/simulated/floor/tiled/white,
/area/medical/surgery)
"at" = (
/obj/effect/floor_decal/corner/blue/diagonal,
/obj/structure/table/glass,
/obj/item/scalpel/laser1,
/obj/item/scalpel/laser2,
/obj/item/scalpel/laser3,
/obj/item/robotanalyzer,
/obj/item/scanner/health,
/obj/item/storage/firstaid/adv,
/turf/simulated/floor/tiled/white,
/area/medical/surgery)
"au" = (
/obj/effect/floor_decal/corner/blue/diagonal,
/obj/structure/ladder,
/turf/simulated/floor/tiled/white,
/area/medical/surgery)
"av" = (
/obj/effect/floor_decal/corner/blue/diagonal,
/obj/machinery/atmospherics/unary/freezer,
/turf/simulated/floor/tiled/white,
/area/medical/surgery)
"aw" = (
/obj/effect/floor_decal/corner/blue/diagonal,
/obj/machinery/fabricator/industrial,
/turf/simulated/floor/tiled/white,
/area/medical/surgery)
"ax" = (
/obj/effect/floor_decal/corner/blue/diagonal,
/obj/machinery/portable_atmospherics/canister/oxygen/prechilled,
/obj/machinery/atmospherics/portables_connector,
/turf/simulated/floor/tiled/white,
/area/medical/surgery)
"ay" = (
/obj/effect/floor_decal/corner/blue/diagonal,
/obj/machinery/light/spot{
	icon_state = "tube_map";
	dir = 4
	},
/turf/simulated/floor/tiled/white,
/area/medical/surgery)
"az" = (
/obj/effect/floor_decal/corner/blue/diagonal,
/obj/structure/closet/secure_closet/freezer/meat,
/turf/simulated/floor/tiled/white,
/area/medical/surgery)
"aA" = (
/obj/effect/floor_decal/corner/blue/diagonal,
/obj/machinery/fabricator/industrial,
/turf/simulated/floor/tiled/white,
/area/medical/surgery)
"aB" = (
/obj/effect/floor_decal/corner/blue/diagonal,
/obj/machinery/atmospherics/pipe/simple/visible/blue{
	icon_state = "intact";
	dir = 5
	},
/turf/simulated/floor/tiled/white,
/area/medical/surgery)
"aC" = (
/obj/effect/floor_decal/corner/blue/diagonal,
/obj/machinery/atmospherics/pipe/manifold/visible/blue,
/turf/simulated/floor/tiled/white,
/area/medical/surgery)
"aD" = (
/obj/effect/floor_decal/corner/blue/diagonal,
/obj/machinery/atmospherics/pipe/simple/visible/blue{
	icon_state = "intact";
	dir = 9
	},
/turf/simulated/floor/tiled/white,
/area/medical/surgery)
"aE" = (
/obj/machinery/atmospherics/unary/vent_pump/on,
/obj/effect/floor_decal/corner/blue/diagonal,
/turf/simulated/floor/tiled/white,
/area/medical/surgery)
"aF" = (
/obj/effect/floor_decal/corner/blue/diagonal,
/obj/machinery/organ_printer/flesh/mapped,
/turf/simulated/floor/tiled/white,
/area/medical/surgery)
"aG" = (
/obj/machinery/atmospherics/pipe/simple/visible{
	icon_state = "intact";
	dir = 5
	},
/obj/effect/floor_decal/corner/blue/diagonal,
/turf/simulated/floor/tiled/white,
/area/medical/surgery)
"aH" = (
/obj/machinery/atmospherics/pipe/simple/visible{
	icon_state = "intact";
	dir = 4
	},
/obj/effect/floor_decal/corner/blue/diagonal,
/turf/simulated/floor/tiled/white,
/area/medical/surgery)
"aI" = (
/obj/machinery/atmospherics/portables_connector{
	icon_state = "map_connector";
	dir = 8
	},
/obj/machinery/portable_atmospherics/canister/air,
/obj/effect/floor_decal/corner/blue/diagonal,
/turf/simulated/floor/tiled/white,
/area/medical/surgery)
"aJ" = (
/obj/effect/floor_decal/corner/blue/diagonal,
/obj/machinery/organ_printer/robot/mapped,
/turf/simulated/floor/tiled/white,
/area/medical/surgery)
"aK" = (
/obj/effect/floor_decal/corner/blue/diagonal,
/obj/structure/table/rack,
/obj/item/stack/material/plasteel/fifty,
/obj/item/stack/material/steel/fifty,
/obj/item/stack/material/glass/fifty,
/obj/item/stack/material/gold/ten,
/obj/item/stack/material/mhydrogen/ten,
/obj/item/stack/material/silver/ten,
/obj/item/stack/material/uranium/ten,
/obj/item/stack/material/diamond/ten,
/obj/item/stack/material/phoron/fifty,
/obj/item/storage/belt/utility/full,
/obj/item/stack/material/steel/fifty,
/turf/simulated/floor/tiled/white,
/area/medical/surgery)
"aL" = (
/obj/machinery/atmospherics/pipe/simple/visible{
	icon_state = "intact";
	dir = 6
	},
/obj/effect/floor_decal/corner/blue/diagonal,
/turf/simulated/floor/tiled/white,
/area/medical/surgery)
"aM" = (
/obj/machinery/atmospherics/portables_connector{
	icon_state = "map_connector";
	dir = 8
	},
/obj/machinery/portable_atmospherics/canister/empty,
/obj/effect/floor_decal/corner/blue/diagonal,
/turf/simulated/floor/tiled/white,
/area/medical/surgery)
"aN" = (
/obj/effect/floor_decal/corner/blue/diagonal,
/turf/simulated/floor/tiled/white,
/area/medical/surgery)
"aO" = (
/obj/machinery/atmospherics/unary/vent_scrubber/on{
	icon_state = "map_scrubber_on";
	dir = 1
	},
/obj/effect/floor_decal/corner/blue/diagonal,
/turf/simulated/floor/tiled/white,
/area/medical/surgery)
"aP" = (
/obj/effect/floor_decal/corner/blue/diagonal,
/obj/machinery/light/spot{
	icon_state = "tube_map";
	dir = 8
	},
/turf/simulated/floor/tiled/white,
/area/medical/surgery)
"aQ" = (
/obj/machinery/light/spot,
/obj/effect/floor_decal/corner/blue/diagonal,
/obj/machinery/fabricator/protolathe,
/turf/simulated/floor/tiled/white,
/area/medical/surgery)
"aR" = (
/obj/structure/cable{
	d2 = 2;
	icon_state = "0-2";
	pixel_y = 0
	},
/obj/machinery/power/apc{
	dir = 8;
	name = "west bump";
	pixel_x = -24
	},
/obj/effect/floor_decal/corner/blue/diagonal,
/turf/simulated/floor/tiled/white,
/area/medical/surgery)
"aS" = (
/obj/structure/cable{
	d1 = 1;
	d2 = 2;
	icon_state = "1-2";
	pixel_y = 0
	},
/obj/effect/floor_decal/corner/blue/diagonal,
/turf/simulated/floor/tiled/white,
/area/medical/surgery)
"aT" = (
/obj/structure/cable,
/obj/machinery/power/debug_items/infinite_generator,
/obj/effect/floor_decal/corner/blue/diagonal,
/turf/simulated/floor/tiled/white,
/area/medical/surgery)
"aU" = (
/obj/machinery/light/spot,
/obj/effect/floor_decal/corner/blue/diagonal,
/turf/simulated/floor/tiled/white,
/area/medical/surgery)
"aV" = (
/obj/effect/floor_decal/corner/blue/diagonal,
/obj/machinery/fabricator/robotics,
/turf/simulated/floor/tiled/white,
/area/medical/surgery)
"aW" = (
/obj/effect/floor_decal/corner/blue/diagonal,
/obj/machinery/fabricator/imprinter,
/turf/simulated/floor/tiled/white,
/area/medical/surgery)
"aX" = (
/obj/effect/floor_decal/corner/blue/diagonal,
/obj/machinery/destructive_analyzer,
/turf/simulated/floor/tiled/white,
/area/medical/surgery)
"aZ" = (
/obj/effect/floor_decal/corner/blue/diagonal,
/obj/machinery/light_switch/on{
	pixel_x = -25
	},
/turf/simulated/floor/tiled/white,
/area/medical/surgery)
"ba" = (
/obj/effect/floor_decal/corner/blue/diagonal,
/obj/machinery/design_database{
	dir = 1
	},
/turf/simulated/floor/tiled/white,
/area/medical/surgery)
"qL" = (
/obj/effect/floor_decal/corner/blue/diagonal,
/obj/machinery/computer/design_console,
/turf/simulated/floor/tiled/white,
/area/medical/surgery)

(1,1,1) = {"
aa
aa
aa
aa
aa
aa
aa
aa
aa
aa
aa
aa
aa
aa
aa
aa
aa
aa
aa
aa
aa
aa
aa
aa
aa
aa
aa
aa
aa
aa
aa
aa
"}
(2,1,1) = {"
aa
aa
aa
aa
aa
aa
aa
aa
aa
aa
aa
aa
aa
aa
aa
aa
aa
aa
aa
aa
aa
aa
aa
aa
aa
aa
aa
aa
aa
aa
aa
aa
"}
(3,1,1) = {"
aa
aa
aa
aa
aa
aa
aa
aa
aa
aa
aa
aa
aa
aa
aa
aa
aa
aa
aa
aa
aa
aa
aa
aa
aa
aa
aa
aa
aa
aa
aa
aa
"}
(4,1,1) = {"
aa
aa
aa
aa
aa
aa
aa
aa
aa
aa
aa
aa
aa
aa
aa
aa
aa
aa
aa
aa
aa
aa
aa
aa
aa
aa
aa
aa
aa
aa
aa
aa
"}
(5,1,1) = {"
aa
aa
aa
aa
aa
aa
aa
aa
aa
aa
aa
aa
aa
aa
aa
aa
aa
aa
aa
aa
aa
aa
aa
aa
aa
aa
aa
aa
aa
aa
aa
aa
"}
(6,1,1) = {"
aa
aa
aa
aa
aa
aa
aa
aa
aa
aa
aa
aa
aa
aa
aa
aa
aa
aa
aa
aa
aa
aa
aa
aa
aa
aa
aa
aa
aa
aa
aa
aa
"}
(7,1,1) = {"
aa
aa
aa
aa
aa
aa
aa
aa
aa
aa
aa
aa
aa
aa
aa
aa
aa
aa
aa
aa
aa
aa
aa
aa
aa
aa
aa
aa
aa
aa
aa
aa
"}
(8,1,1) = {"
aa
aa
aa
aa
aa
aa
aa
aa
aa
aa
aa
aa
aa
aa
aa
aa
aa
aa
aa
aa
aa
aa
aa
aa
aa
aa
aa
aa
aa
aa
aa
aa
"}
(9,1,1) = {"
aa
aa
aa
aa
aa
aa
aa
aa
aa
aa
aa
aa
aa
aa
aa
aa
aa
aa
aa
aa
aa
aa
aa
aa
aa
aa
aa
aa
aa
aa
aa
aa
"}
(10,1,1) = {"
aa
aa
aa
aa
aa
aa
aa
aa
aa
aa
aa
aa
aa
aa
aa
aa
aa
aa
aa
aa
aa
aa
aa
aa
aa
aa
aa
aa
aa
aa
aa
aa
"}
(11,1,1) = {"
aa
aa
aa
aa
aa
aa
aa
aa
aa
aa
aa
aa
aa
aa
aa
aa
aa
aa
aa
aa
aa
aa
aa
aa
aa
aa
aa
aa
aa
aa
aa
aa
"}
(12,1,1) = {"
aa
aa
aa
aa
aa
aa
aa
aa
aa
aa
aa
aa
aa
aa
aa
aa
aa
aa
aa
aa
aa
aa
aa
aa
aa
aa
aa
aa
aa
aa
aa
aa
"}
(13,1,1) = {"
aa
aa
aa
aa
aa
aa
aa
aa
aa
aa
aa
aa
aa
aa
aa
aa
aa
aa
aa
aa
aa
aa
aa
aa
aa
aa
aa
aa
aa
aa
aa
aa
"}
(14,1,1) = {"
aa
aa
aa
aa
aa
aa
aa
aa
aa
ab
aa
aa
aa
aa
aa
aa
aa
aa
aa
aa
aa
aa
aa
aa
aa
aa
aa
aa
aa
aa
aa
aa
"}
(15,1,1) = {"
aa
aa
aa
aa
aa
aa
aa
aa
aa
aa
aa
aa
aa
aa
aa
aa
aa
aa
aa
aa
aa
aa
aa
aa
aa
aa
aa
aa
aa
aa
aa
aa
"}
(16,1,1) = {"
aa
aa
aa
aa
aa
aa
aa
aa
aa
aa
aa
aa
aa
aa
aa
aa
aa
aa
aa
aa
aa
aa
aa
aa
aa
aa
aa
aa
aa
aa
aa
aa
"}
(17,1,1) = {"
aa
aa
aa
aa
aa
aa
aa
aa
aa
aa
aa
aa
aa
aa
aa
aa
aa
aa
aa
aa
aa
aa
aa
aa
aa
aa
aa
aa
aa
aa
aa
aa
"}
(18,1,1) = {"
aa
aa
aa
aa
aa
aa
aa
aa
aa
ac
ac
ac
ac
ac
ac
ac
ac
ac
ac
ac
ac
ac
ac
ac
aa
aa
aa
aa
aa
aa
aa
aa
"}
(19,1,1) = {"
aa
aa
aa
aa
aa
aa
aa
aa
aa
ac
ad
al
ao
at
az
aF
aJ
aZ
aN
aP
aR
aS
aT
ac
aa
aa
aa
aa
aa
aa
aa
aa
"}
(20,1,1) = {"
aa
aa
aa
aa
aa
aa
aa
aa
aa
ac
ae
aN
ap
aN
aN
aN
aN
aN
aN
aN
aN
aN
aW
ac
aa
aa
aa
aa
aa
aa
aa
aa
"}
(21,1,1) = {"
aa
aa
aa
aa
aa
aa
aa
aa
aa
ac
af
aN
aq
aN
aA
aN
aK
aN
aN
aN
aw
aN
aX
ac
aa
aa
aa
aa
aa
aa
aa
aa
"}
(22,1,1) = {"
aa
aa
aa
aa
aa
aa
aa
aa
aa
ac
ag
aN
aN
aN
aN
aN
aN
aN
aN
aN
aN
aN
aQ
ac
aa
aa
aa
aa
aa
aa
aa
aa
"}
(23,1,1) = {"
aa
aa
aa
aa
aa
aa
aa
aa
aa
ac
ah
am
ar
au
aN
aN
aN
aN
aN
aN
aV
aN
ba
ac
aa
aa
aa
aa
aa
aa
aa
aa
"}
(24,1,1) = {"
aa
aa
aa
aa
aa
aa
aa
aa
aa
ac
aN
aj
an
av
aB
aN
aN
aN
aN
aN
qL
aN
ba
ac
aa
aa
aa
aa
aa
aa
aa
aa
"}
(25,1,1) = {"
aa
aa
aa
aa
aa
aa
aa
aa
aa
ac
aj
aj
an
ai
aC
aN
aN
aN
aN
aN
aN
aN
ba
ac
aa
aa
aa
aa
aa
aa
aa
aa
"}
(26,1,1) = {"
aa
aa
aa
aa
aa
aa
aa
aa
aa
ac
aN
an
an
ax
aD
aN
aN
aN
aN
aN
aN
aN
aN
ac
aa
aa
aa
aa
aa
aa
aa
aa
"}
(27,1,1) = {"
aa
aa
aa
aa
aa
aa
aa
aa
aa
ac
aN
aN
aN
aN
aN
aN
aN
aN
aN
aN
aN
aN
aN
ac
aa
aa
aa
aa
aa
aa
aa
aa
"}
(28,1,1) = {"
aa
aa
aa
aa
aa
aa
aa
aa
aa
ac
ak
aN
aN
aN
aN
aN
aN
aN
aN
aN
aN
aN
aU
ac
aa
aa
aa
aa
aa
aa
aa
aa
"}
(29,1,1) = {"
aa
aa
aa
aa
aa
aa
aa
aa
aa
ac
aN
aN
aN
aN
aE
aG
aN
aL
aO
aN
aN
aN
aN
ac
aa
aa
aa
aa
aa
aa
aa
aa
"}
(30,1,1) = {"
aa
aa
aa
aa
aa
aa
aa
aa
aa
ac
aN
aN
aN
aN
aN
aH
aN
aH
aN
aN
aN
aN
aN
ac
aa
aa
aa
aa
aa
aa
aa
aa
"}
(31,1,1) = {"
aa
aa
aa
aa
aa
aa
aa
aa
aa
ac
aN
aN
as
ay
aN
aI
aN
aM
aN
aN
ay
aN
aN
ac
aa
aa
aa
aa
aa
aa
aa
aa
"}
(32,1,1) = {"
aa
aa
aa
aa
aa
aa
aa
aa
aa
ac
ac
ac
ac
ac
ac
ac
ac
ac
ac
ac
ac
ac
ac
ac
aa
aa
aa
aa
aa
aa
aa
aa
"}
(33,1,1) = {"
aa
aa
aa
aa
aa
aa
aa
aa
aa
aa
aa
aa
aa
aa
aa
aa
aa
aa
aa
aa
aa
aa
aa
aa
aa
aa
aa
aa
aa
aa
aa
aa
"}
(34,1,1) = {"
aa
aa
aa
aa
aa
aa
aa
aa
aa
aa
aa
aa
aa
aa
aa
aa
aa
aa
aa
aa
aa
aa
aa
aa
aa
aa
aa
aa
aa
aa
aa
aa
"}
(35,1,1) = {"
aa
aa
aa
aa
aa
aa
aa
aa
aa
aa
aa
aa
aa
aa
aa
aa
aa
aa
aa
aa
aa
aa
aa
aa
aa
aa
aa
aa
aa
aa
aa
aa
"}
(36,1,1) = {"
aa
aa
aa
aa
aa
aa
aa
aa
aa
aa
aa
aa
aa
aa
aa
aa
aa
aa
aa
aa
aa
aa
aa
aa
aa
aa
aa
aa
aa
aa
aa
aa
"}
(37,1,1) = {"
aa
aa
aa
aa
aa
aa
aa
aa
aa
aa
aa
aa
aa
aa
aa
aa
aa
aa
aa
aa
aa
aa
aa
aa
aa
aa
aa
aa
aa
aa
aa
aa
"}
(38,1,1) = {"
aa
aa
aa
aa
aa
aa
aa
aa
aa
aa
aa
aa
aa
aa
aa
aa
aa
aa
aa
aa
aa
aa
aa
aa
aa
aa
aa
aa
aa
aa
aa
aa
"}
(39,1,1) = {"
aa
aa
aa
aa
aa
aa
aa
aa
aa
aa
aa
aa
aa
aa
aa
aa
aa
aa
aa
aa
aa
aa
aa
aa
aa
aa
aa
aa
aa
aa
aa
aa
"}
(40,1,1) = {"
aa
aa
aa
aa
aa
aa
aa
aa
aa
aa
aa
aa
aa
aa
aa
aa
aa
aa
aa
aa
aa
aa
aa
aa
aa
aa
aa
aa
aa
aa
aa
aa
"}
(41,1,1) = {"
aa
aa
aa
aa
aa
aa
aa
aa
aa
aa
aa
aa
aa
aa
aa
aa
aa
aa
aa
aa
aa
aa
aa
aa
aa
aa
aa
aa
aa
aa
aa
aa
"}
(42,1,1) = {"
aa
aa
aa
aa
aa
aa
aa
aa
aa
aa
aa
aa
aa
aa
aa
aa
aa
aa
aa
aa
aa
aa
aa
aa
aa
aa
aa
aa
aa
aa
aa
aa
"}
(43,1,1) = {"
aa
aa
aa
aa
aa
aa
aa
aa
aa
aa
aa
aa
aa
aa
aa
aa
aa
aa
aa
aa
aa
aa
aa
aa
aa
aa
aa
aa
aa
aa
aa
aa
"}
(44,1,1) = {"
aa
aa
aa
aa
aa
aa
aa
aa
aa
aa
aa
aa
aa
aa
aa
aa
aa
aa
aa
aa
aa
aa
aa
aa
aa
aa
aa
aa
aa
aa
aa
aa
"}
(45,1,1) = {"
aa
aa
aa
aa
aa
aa
aa
aa
aa
aa
aa
aa
aa
aa
aa
aa
aa
aa
aa
aa
aa
aa
aa
aa
aa
aa
aa
aa
aa
aa
aa
aa
"}
(46,1,1) = {"
aa
aa
aa
aa
aa
aa
aa
aa
aa
aa
aa
aa
aa
aa
aa
aa
aa
aa
aa
aa
aa
aa
aa
aa
aa
aa
aa
aa
aa
aa
aa
aa
"}
(47,1,1) = {"
aa
aa
aa
aa
aa
aa
aa
aa
aa
aa
aa
aa
aa
aa
aa
aa
aa
aa
aa
aa
aa
aa
aa
aa
aa
aa
aa
aa
aa
aa
aa
aa
"}
(48,1,1) = {"
aa
aa
aa
aa
aa
aa
aa
aa
aa
aa
aa
aa
aa
aa
aa
aa
aa
aa
aa
aa
aa
aa
aa
aa
aa
aa
aa
aa
aa
aa
aa
aa
"}
