//MAP CONVERTED BY dmm2tgm.py THIS HEADER COMMENT PREVENTS RECONVERSION, DO NOT REMOVE
"a" = (
/turf/space,
/area/space)
"b" = (
/turf/simulated/wall/r_wall,
/area/space)
"c" = (
/turf/simulated/wall,
/area/maintenance/fsmaint2)
"d" = (
/obj/effect/floor_decal/corner/orange/mono,
/turf/simulated/floor/tiled/monotile,
/area/maintenance/fsmaint2)
"e" = (
/obj/machinery/light/spot{
	dir = 1
	},
/obj/effect/floor_decal/corner/orange{
	dir = 5
	},
/turf/simulated/floor/tiled/steel_grid,
/area/maintenance/fsmaint2)
"f" = (
/obj/structure/lattice,
/turf/simulated/open,
/area/maintenance/fsmaint2)
"g" = (
/turf/simulated/open,
/area/maintenance/fsmaint2)
"h" = (
/obj/machinery/light_switch/on{
	dir = 8;
	pixel_x = 24
	},
/obj/machinery/atmospherics/pipe/simple/hidden,
/obj/effect/floor_decal/corner/orange{
	dir = 6
	},
/turf/simulated/floor/tiled/steel_grid,
/area/maintenance/fsmaint2)
"i" = (
/obj/effect/shuttle_landmark/upper_level,
/turf/space,
/area/space)
"j" = (
/obj/machinery/light/spot{
	dir = 8
	},
/obj/effect/floor_decal/corner/orange{
	dir = 9
	},
/turf/simulated/floor/tiled/steel_grid,
/area/maintenance/fsmaint2)
"k" = (
/obj/structure/ladder,
/obj/structure/railing/mapped{
	dir = 4
	},
/turf/simulated/floor/tiled/steel_grid,
/area/maintenance/fsmaint2)
"l" = (
/obj/machinery/atmospherics/pipe/simple/hidden{
	dir = 4
	},
/obj/machinery/door/airlock/external/bolted{
	id_tag = "upper_level_dock_hatch_internal"
	},
/obj/machinery/button/access/interior{
	id_tag = "upper_level_dock";
	pixel_y = -21
	},
/turf/simulated/floor,
/area/maintenance/fsmaint2)
"m" = (
/obj/machinery/door/airlock/external/bolted{
	id_tag = "upper_level_dock_hatch_external"
	},
/obj/machinery/button/access/exterior{
	id_tag = "upper_level_dock";
	pixel_y = -21
	},
/turf/simulated/floor,
/area/maintenance/fsmaint2)
"n" = (
/obj/machinery/atmospherics/pipe/simple/hidden{
	dir = 6
	},
/turf/simulated/floor/tiled/steel_grid,
/area/maintenance/fsmaint2)
"q" = (
/obj/machinery/atmospherics/pipe/manifold/hidden,
/turf/simulated/floor/tiled/steel_grid,
/area/maintenance/fsmaint2)
"s" = (
/obj/machinery/atmospherics/portables_connector{
	dir = 8
	},
/obj/machinery/portable_atmospherics/canister/air,
/obj/effect/floor_decal/corner/orange/mono,
/turf/simulated/floor/tiled/monotile,
/area/maintenance/fsmaint2)
"t" = (
/obj/machinery/atmospherics/pipe/manifold/hidden{
	dir = 1
	},
/turf/simulated/floor/tiled/steel_grid,
/area/maintenance/fsmaint2)
"u" = (
/obj/machinery/atmospherics/portables_connector{
	dir = 8
	},
/obj/machinery/portable_atmospherics/canister/empty,
/obj/effect/floor_decal/corner/orange/mono,
/turf/simulated/floor/tiled/monotile,
/area/maintenance/fsmaint2)
"v" = (
/obj/machinery/light/spot{
	dir = 1
	},
/obj/effect/floor_decal/corner/orange{
	dir = 5
	},
/obj/effect/floor_decal/industrial/warning{
	dir = 8
	},
/turf/simulated/floor/tiled/steel_grid,
/area/maintenance/fsmaint2)
"x" = (
/obj/machinery/light/spot,
/obj/effect/floor_decal/corner/orange{
	dir = 10
	},
/turf/simulated/floor/tiled/steel_grid,
/area/maintenance/fsmaint2)
"y" = (
/obj/structure/cable{
	d2 = 2;
	icon_state = "0-2"
	},
/obj/machinery/power/apc{
	dir = 8;
	name = "west bump";
	pixel_x = -24
	},
/obj/effect/floor_decal/corner/orange{
	dir = 9
	},
/turf/simulated/floor/tiled/steel_grid,
/area/maintenance/fsmaint2)
"z" = (
/obj/structure/cable{
	d1 = 1;
	d2 = 2;
	icon_state = "1-2"
	},
/obj/effect/floor_decal/corner/orange{
	dir = 9
	},
/turf/simulated/floor/tiled/steel_grid,
/area/maintenance/fsmaint2)
"A" = (
/obj/structure/cable,
/obj/machinery/power/debug_items/infinite_generator,
/obj/effect/floor_decal/corner/orange/mono,
/turf/simulated/floor/tiled/monotile,
/area/maintenance/fsmaint2)
"B" = (
/obj/effect/floor_decal/corner/orange{
	dir = 10
	},
/turf/simulated/floor/tiled/steel_grid,
/area/maintenance/fsmaint2)
"C" = (
/obj/machinery/atmospherics/pipe/simple/hidden,
/obj/effect/floor_decal/corner/orange{
	dir = 6
	},
/turf/simulated/floor/tiled/steel_grid,
/area/maintenance/fsmaint2)
"E" = (
/obj/machinery/atmospherics/pipe/simple/hidden{
	dir = 5
	},
/turf/simulated/floor/tiled/steel_grid,
/area/maintenance/fsmaint2)
"F" = (
/obj/machinery/atmospherics/portables_connector,
/obj/machinery/portable_atmospherics/canister/air/airlock,
/obj/effect/floor_decal/corner/orange/mono,
/turf/simulated/floor/tiled/monotile,
/area/maintenance/fsmaint2)
"G" = (
/obj/machinery/atmospherics/pipe/simple/hidden{
	dir = 4
	},
/turf/simulated/floor/tiled/steel_grid,
/area/maintenance/fsmaint2)
"H" = (
/obj/effect/floor_decal/industrial/warning/corner{
	dir = 1
	},
/turf/simulated/floor/tiled/steel_grid,
/area/maintenance/fsmaint2)
"I" = (
/obj/effect/floor_decal/industrial/warning{
	dir = 1
	},
/turf/simulated/floor/tiled/steel_grid,
/area/maintenance/fsmaint2)
"J" = (
/obj/effect/floor_decal/industrial/warning{
	dir = 8
	},
/turf/simulated/floor/tiled/steel_grid,
/area/maintenance/fsmaint2)
"K" = (
/obj/effect/floor_decal/corner/orange{
	dir = 6
	},
/turf/simulated/floor/tiled/steel_grid,
/area/maintenance/fsmaint2)
"L" = (
/obj/machinery/light_switch/on{
	dir = 4;
	pixel_x = -24
	},
/obj/effect/floor_decal/corner/orange{
	dir = 9
	},
/turf/simulated/floor/tiled/steel_grid,
/area/maintenance/fsmaint2)
"M" = (
/obj/structure/railing/mapped{
	dir = 4
	},
/turf/simulated/floor/tiled/steel_grid,
/area/maintenance/fsmaint2)
"P" = (
/obj/structure/railing/mapped{
	dir = 4
	},
/obj/effect/floor_decal/corner/orange{
	dir = 5
	},
/turf/simulated/floor/tiled/steel_grid,
/area/maintenance/fsmaint2)
"Q" = (
/obj/machinery/atmospherics/unary/vent_pump/on,
/turf/simulated/floor/tiled/steel_grid,
/area/maintenance/fsmaint2)
"S" = (
/obj/machinery/atmospherics/unary/vent_pump/high_volume/external_air{
	dir = 8;
	id_tag = "upper_level_dock_pump"
	},
/obj/machinery/embedded_controller/radio/airlock/docking_port{
	id_tag = "upper_level_dock";
	pixel_y = 24;
	tag_airpump = "upper_level_dock_pump";
	tag_chamber_sensor = "upper_level_dock_sensor_chamber";
	tag_exterior_door = "upper_level_dock_hatch_external";
	tag_interior_door = "upper_level_dock_hatch_internal"
	},
/obj/machinery/airlock_sensor{
	id_tag = "upper_level_dock_sensor_chamber";
	pixel_y = -21
	},
/turf/simulated/floor,
/area/maintenance/fsmaint2)
"T" = (
/obj/machinery/light/spot{
	dir = 4
	},
/obj/effect/floor_decal/corner/orange{
	dir = 6
	},
/turf/simulated/floor/tiled/steel_grid,
/area/maintenance/fsmaint2)
"U" = (
/obj/machinery/atmospherics/unary/vent_scrubber/on{
	dir = 1
	},
/turf/simulated/floor/tiled/steel_grid,
/area/maintenance/fsmaint2)
"V" = (
/obj/effect/landmark/map_data{
	height = 3
	},
/turf/space,
/area/space)
"W" = (
/turf/simulated/floor/tiled/steel_grid,
/area/maintenance/fsmaint2)
"X" = (
/obj/effect/floor_decal/industrial/warning/corner{
	dir = 4
	},
/turf/simulated/floor/tiled/steel_grid,
/area/maintenance/fsmaint2)
"Y" = (
/obj/effect/floor_decal/corner/orange{
	dir = 5
	},
/turf/simulated/floor/tiled/steel_grid,
/area/maintenance/fsmaint2)
"Z" = (
/obj/effect/floor_decal/corner/orange{
	dir = 9
	},
/turf/simulated/floor/tiled/steel_grid,
/area/maintenance/fsmaint2)

(1,1,1) = {"
a
a
a
a
a
a
a
a
a
a
a
a
a
a
a
a
a
a
a
a
a
a
a
a
a
a
a
a
a
a
a
V
"}
(2,1,1) = {"
a
a
a
a
a
a
a
a
a
a
a
a
a
a
a
a
a
a
a
a
a
a
a
a
a
a
a
a
a
a
a
a
"}
(3,1,1) = {"
a
a
a
a
a
a
a
a
a
a
a
a
a
a
a
a
a
a
a
a
a
a
a
a
a
a
a
a
a
a
a
a
"}
(4,1,1) = {"
a
a
a
a
a
a
a
a
a
a
a
a
a
a
a
a
a
a
a
a
a
a
a
a
a
a
a
a
a
a
a
a
"}
(5,1,1) = {"
a
a
a
a
a
a
a
a
a
a
a
a
a
a
a
a
a
a
a
a
a
a
a
a
a
a
a
a
a
a
a
a
"}
(6,1,1) = {"
a
a
a
a
a
a
a
a
a
a
a
a
a
a
a
a
a
a
a
a
a
a
a
a
a
a
a
a
a
a
a
a
"}
(7,1,1) = {"
a
a
a
a
a
a
a
a
a
a
a
a
a
a
a
a
a
a
a
a
a
a
a
a
a
a
a
a
a
a
a
a
"}
(8,1,1) = {"
a
a
a
a
a
a
a
a
a
a
a
a
a
a
a
a
a
a
a
a
a
a
a
a
a
a
a
a
a
a
a
a
"}
(9,1,1) = {"
a
a
a
a
a
a
a
a
a
a
a
a
a
a
a
a
a
a
a
a
a
a
a
a
a
a
a
a
a
a
a
a
"}
(10,1,1) = {"
a
a
a
a
a
a
a
a
a
a
a
a
a
a
a
a
a
a
a
a
a
a
a
a
a
a
a
a
a
a
a
a
"}
(11,1,1) = {"
a
a
a
a
a
a
a
a
a
a
a
a
a
a
a
a
a
a
a
a
a
a
a
a
a
a
a
a
a
a
a
a
"}
(12,1,1) = {"
a
a
a
a
a
a
a
a
a
a
a
a
a
a
a
a
a
a
a
a
a
a
a
a
a
a
a
a
a
a
a
a
"}
(13,1,1) = {"
a
a
a
a
a
a
a
a
a
a
a
a
a
a
a
a
a
a
a
a
a
a
a
a
a
a
a
a
a
a
a
a
"}
(14,1,1) = {"
a
a
a
a
a
a
a
a
a
a
a
a
a
a
a
a
a
a
a
a
a
a
a
a
a
a
a
a
a
a
a
a
"}
(15,1,1) = {"
a
a
a
a
a
a
a
a
a
a
a
a
a
a
a
a
a
a
a
a
a
a
a
a
a
a
a
a
a
a
a
a
"}
(16,1,1) = {"
a
a
a
a
a
a
a
b
b
b
b
b
b
b
b
b
b
b
b
b
b
b
b
b
b
b
a
a
a
a
a
a
"}
(17,1,1) = {"
a
a
a
a
a
a
a
b
b
b
b
b
b
b
b
b
b
b
b
b
b
b
b
b
b
b
a
a
a
a
a
a
"}
(18,1,1) = {"
a
a
a
a
a
a
a
b
b
c
c
c
c
c
c
c
c
c
c
c
c
c
c
c
b
b
a
a
a
a
a
a
"}
(19,1,1) = {"
a
a
a
a
a
a
a
b
b
c
d
Z
Z
j
Z
Z
L
Z
Z
j
y
z
A
c
b
b
a
a
a
a
a
a
"}
(20,1,1) = {"
a
a
a
a
a
a
a
b
b
c
Y
W
W
W
W
W
W
W
W
W
W
W
B
c
b
b
a
a
a
a
a
a
"}
(21,1,1) = {"
a
a
a
a
a
a
a
b
b
c
Y
W
W
W
Q
E
W
n
U
W
W
W
B
c
b
b
a
a
a
a
a
a
"}
(22,1,1) = {"
a
a
a
a
a
a
a
b
b
c
e
W
W
W
W
G
W
G
W
W
W
W
x
c
b
b
a
a
a
a
a
a
"}
(23,1,1) = {"
a
a
a
a
a
a
a
b
b
c
P
M
M
k
X
G
W
G
W
W
W
W
B
c
b
b
a
a
a
a
a
a
"}
(24,1,1) = {"
a
a
a
a
a
a
a
b
b
c
f
g
g
g
I
G
W
G
W
W
W
W
B
c
b
b
a
a
a
a
a
a
"}
(25,1,1) = {"
a
a
a
a
a
a
a
b
b
c
f
g
g
g
I
G
W
G
W
W
W
W
B
c
b
b
a
a
a
a
a
a
"}
(26,1,1) = {"
a
a
a
a
a
a
a
b
b
c
f
g
g
g
I
G
W
G
W
W
W
W
B
c
b
b
a
a
a
a
a
a
"}
(27,1,1) = {"
a
a
a
a
a
a
a
b
b
c
f
g
g
g
I
G
W
G
W
W
W
W
B
c
b
b
a
a
a
a
a
a
"}
(28,1,1) = {"
a
a
a
a
a
a
a
b
b
c
v
J
J
J
H
G
W
G
W
W
W
W
x
c
b
b
a
a
a
a
a
a
"}
(29,1,1) = {"
a
a
a
a
a
a
a
b
b
c
Y
W
W
W
Q
q
W
t
U
W
W
W
B
c
b
b
a
a
a
a
a
a
"}
(30,1,1) = {"
a
a
a
a
a
a
a
b
b
c
Y
W
W
W
W
G
W
G
W
W
W
W
B
c
b
b
a
a
a
a
a
a
"}
(31,1,1) = {"
a
a
a
a
a
a
a
b
b
c
F
C
h
E
T
s
K
u
K
K
T
K
d
c
b
b
a
a
a
a
a
a
"}
(32,1,1) = {"
a
a
a
a
a
a
a
b
b
c
c
c
c
l
c
c
c
c
c
c
c
c
c
c
b
b
a
a
a
a
a
a
"}
(33,1,1) = {"
a
a
a
a
a
a
a
b
b
b
b
b
c
S
c
b
b
b
b
b
b
b
b
b
b
b
a
a
a
a
a
a
"}
(34,1,1) = {"
a
a
a
a
a
a
a
b
b
b
b
b
c
m
c
b
b
b
b
b
b
b
b
b
b
b
a
a
a
a
a
a
"}
(35,1,1) = {"
a
a
a
a
a
a
a
a
a
a
a
a
a
a
a
a
a
a
a
a
a
a
a
a
a
a
a
a
a
a
a
a
"}
(36,1,1) = {"
a
a
a
a
a
a
a
a
a
a
a
a
i
a
a
a
a
a
a
a
a
a
a
a
a
a
a
a
a
a
a
a
"}
(37,1,1) = {"
a
a
a
a
a
a
a
a
a
a
a
a
a
a
a
a
a
a
a
a
a
a
a
a
a
a
a
a
a
a
a
a
"}
(38,1,1) = {"
a
a
a
a
a
a
a
a
a
a
a
a
a
a
a
a
a
a
a
a
a
a
a
a
a
a
a
a
a
a
a
a
"}
(39,1,1) = {"
a
a
a
a
a
a
a
a
a
a
a
a
a
a
a
a
a
a
a
a
a
a
a
a
a
a
a
a
a
a
a
a
"}
(40,1,1) = {"
a
a
a
a
a
a
a
a
a
a
a
a
a
a
a
a
a
a
a
a
a
a
a
a
a
a
a
a
a
a
a
a
"}
(41,1,1) = {"
a
a
a
a
a
a
a
a
a
a
a
a
a
a
a
a
a
a
a
a
a
a
a
a
a
a
a
a
a
a
a
a
"}
(42,1,1) = {"
a
a
a
a
a
a
a
a
a
a
a
a
a
a
a
a
a
a
a
a
a
a
a
a
a
a
a
a
a
a
a
a
"}
(43,1,1) = {"
a
a
a
a
a
a
a
a
a
a
a
a
a
a
a
a
a
a
a
a
a
a
a
a
a
a
a
a
a
a
a
a
"}
(44,1,1) = {"
a
a
a
a
a
a
a
a
a
a
a
a
a
a
a
a
a
a
a
a
a
a
a
a
a
a
a
a
a
a
a
a
"}
(45,1,1) = {"
a
a
a
a
a
a
a
a
a
a
a
a
a
a
a
a
a
a
a
a
a
a
a
a
a
a
a
a
a
a
a
a
"}
(46,1,1) = {"
a
a
a
a
a
a
a
a
a
a
a
a
a
a
a
a
a
a
a
a
a
a
a
a
a
a
a
a
a
a
a
a
"}
(47,1,1) = {"
a
a
a
a
a
a
a
a
a
a
a
a
a
a
a
a
a
a
a
a
a
a
a
a
a
a
a
a
a
a
a
a
"}
(48,1,1) = {"
a
a
a
a
a
a
a
a
a
a
a
a
a
a
a
a
a
a
a
a
a
a
a
a
a
a
a
a
a
a
a
a
"}
