//MAP CONVERTED BY dmm2tgm.py THIS HEADER COMMENT PREVENTS RECONVERSION, DO NOT REMOVE
"ck" = (
/obj/structure/table/steel,
/obj/machinery/recharger,
/turf/simulated/floor/tiled/steel_grid,
/area/constructionsite)
"cS" = (
/obj/machinery/fabricator/hacked,
/turf/simulated/floor/tiled/steel_grid,
/area/constructionsite)
"cV" = (
/obj/machinery/computer/shuttle_control{
	shuttle_tag = "Example"
	},
/turf/simulated/floor/plating,
/area/shuttle/escape)
"eg" = (
/turf/simulated/wall,
/area/constructionsite)
"fQ" = (
/obj/machinery/door/airlock/external/bolted{
	id_tag = "lower_level_dock_hatch_external"
	},
/obj/machinery/button/access/exterior{
	id_tag = "lower_level_dock";
	pixel_y = -21
	},
/turf/simulated/floor,
/area/constructionsite)
"fT" = (
/obj/machinery/atmospherics/pipe/simple/hidden{
	dir = 6
	},
/turf/simulated/floor/tiled/steel_grid,
/area/constructionsite)
"fU" = (
/turf/simulated/wall/r_wall,
/area/space)
"gO" = (
/obj/structure/table/rack,
/obj/item/stack/material/reinforced/mapped/plasteel/fifty,
/obj/item/stack/material/ingot/mapped/copper/fifty,
/obj/item/stack/material/sheet/mapped/steel/fifty,
/obj/item/stack/material/pane/mapped/glass/fifty,
/obj/item/stack/material/reinforced/mapped/fiberglass/fifty,
/obj/item/stack/material/ingot/mapped/gold/ten,
/obj/item/stack/material/segment/mapped/mhydrogen/ten,
/obj/item/stack/material/ingot/mapped/silver/ten,
/obj/item/stack/material/puck/mapped/uranium/ten,
/obj/item/stack/material/gemstone/mapped/diamond/ten,
/obj/item/storage/belt/utility/full,
/obj/item/stack/material/sheet/mapped/steel/fifty,
/turf/simulated/floor/tiled/steel_grid,
/area/constructionsite)
"hw" = (
/obj/machinery/embedded_controller/radio/airlock/docking_port{
	id_tag = "lower_level_dock";
	pixel_y = 24;
	tag_airpump = "lower_level_dock_pump";
	tag_chamber_sensor = "lower_level_dock_sensor_chamber";
	tag_exterior_door = "lower_level_dock_hatch_external";
	tag_interior_door = "lower_level_dock_hatch_internal"
	},
/obj/machinery/atmospherics/unary/vent_pump/high_volume/external_air{
	dir = 4;
	id_tag = "lower_level_dock_pump"
	},
/obj/machinery/airlock_sensor{
	id_tag = "lower_level_dock_sensor_chamber";
	pixel_y = -21
	},
/turf/simulated/floor,
/area/constructionsite)
"iM" = (
/obj/machinery/atmospherics/unary/vent_scrubber/on{
	dir = 1
	},
/turf/simulated/floor/tiled/steel_grid,
/area/constructionsite)
"jg" = (
/obj/machinery/door/airlock/external/bolted{
	id_tag = "example_shuttle_port_hatch"
	},
/turf/simulated/floor/plating,
/area/shuttle/escape)
"jB" = (
/obj/structure/table/rack,
/obj/item/gun/projectile/automatic/assault_rifle,
/obj/item/gun/projectile/automatic/assault_rifle,
/obj/item/gun/projectile/automatic/assault_rifle,
/turf/simulated/floor/tiled/steel_grid,
/area/constructionsite)
"jO" = (
/obj/effect/floor_decal/industrial/warning/corner{
	dir = 1
	},
/turf/simulated/floor/tiled/steel_grid,
/area/constructionsite)
"jV" = (
/obj/structure/ladder,
/obj/effect/floor_decal/industrial/warning{
	dir = 4
	},
/turf/simulated/floor/tiled/steel_grid,
/area/constructionsite)
"kw" = (
/obj/machinery/light_switch/on{
	dir = 8;
	pixel_x = 24
	},
/obj/effect/floor_decal/corner/orange{
	dir = 6
	},
/turf/simulated/floor/tiled/steel_grid,
/area/constructionsite)
"oZ" = (
/obj/structure/cable,
/obj/machinery/power/debug_items/infinite_generator,
/obj/effect/floor_decal/corner/orange/mono,
/turf/simulated/floor/tiled/monotile,
/area/constructionsite)
"pm" = (
/obj/effect/floor_decal/corner/orange{
	dir = 5
	},
/obj/machinery/computer/teleporter,
/turf/simulated/floor/tiled/steel_grid,
/area/constructionsite)
"qt" = (
/obj/effect/floor_decal/industrial/warning/corner,
/obj/effect/floor_decal/corner/orange{
	dir = 5
	},
/turf/simulated/floor/tiled/steel_grid,
/area/constructionsite)
"qJ" = (
/turf/simulated/floor/tiled/steel_grid,
/area/constructionsite)
"rY" = (
/obj/machinery/atmospherics/pipe/simple/hidden{
	dir = 9
	},
/turf/simulated/floor/tiled/steel_grid,
/area/constructionsite)
"se" = (
/obj/structure/table/rack,
/obj/item/gun/energy/laser,
/obj/item/gun/energy/laser,
/obj/item/gun/energy/laser,
/turf/simulated/floor/tiled/steel_grid,
/area/constructionsite)
"sQ" = (
/obj/machinery/atmospherics/portables_connector,
/obj/machinery/portable_atmospherics/canister/air/airlock,
/obj/effect/floor_decal/corner/orange/mono,
/turf/simulated/floor/tiled/monotile,
/area/constructionsite)
"sT" = (
/obj/machinery/light/spot,
/turf/simulated/floor/plating,
/area/shuttle/escape)
"tg" = (
/obj/machinery/light_switch/on{
	dir = 4;
	pixel_x = -24
	},
/obj/effect/floor_decal/corner/orange{
	dir = 9
	},
/turf/simulated/floor/tiled/steel_grid,
/area/constructionsite)
"tq" = (
/obj/structure/table/rack,
/obj/item/gun/projectile/revolver,
/obj/item/gun/projectile/revolver,
/obj/item/gun/projectile/revolver,
/turf/simulated/floor/tiled/steel_grid,
/area/constructionsite)
"tE" = (
/obj/effect/floor_decal/industrial/warning{
	dir = 4
	},
/turf/simulated/floor/tiled/steel_grid,
/area/constructionsite)
"us" = (
/obj/effect/landmark/latejoin,
/turf/simulated/floor/tiled/steel_grid,
/area/constructionsite)
"vd" = (
/obj/machinery/atmospherics/unary/vent_pump/on,
/turf/simulated/floor/tiled/steel_grid,
/area/constructionsite)
"wj" = (
/obj/item/radio/beacon,
/turf/simulated/floor/tiled/steel_grid,
/area/constructionsite)
"wB" = (
/obj/machinery/atmospherics/pipe/simple/hidden{
	dir = 4
	},
/turf/simulated/floor/tiled/steel_grid,
/area/constructionsite)
"wF" = (
/obj/effect/floor_decal/corner/orange/mono,
/turf/simulated/floor/tiled/monotile,
/area/constructionsite)
"xk" = (
/turf/simulated/wall/titanium,
/area/shuttle/escape)
"xF" = (
/obj/turbolift_map_holder/example,
/turf/simulated/floor/plating,
/area/constructionsite)
"yN" = (
/obj/effect/floor_decal/industrial/warning/corner{
	dir = 8
	},
/obj/effect/floor_decal/corner/orange{
	dir = 5
	},
/turf/simulated/floor/tiled/steel_grid,
/area/constructionsite)
"Af" = (
/obj/machinery/atmospherics/pipe/manifold/hidden,
/turf/simulated/floor/tiled/steel_grid,
/area/constructionsite)
"Bv" = (
/obj/effect/landmark/start,
/turf/simulated/floor/tiled/steel_grid,
/area/constructionsite)
"BV" = (
/obj/machinery/atmospherics/portables_connector{
	dir = 8
	},
/obj/machinery/portable_atmospherics/canister/empty,
/obj/effect/floor_decal/corner/orange/mono,
/turf/simulated/floor/tiled/monotile,
/area/constructionsite)
"EO" = (
/obj/effect/floor_decal/corner/orange{
	dir = 5
	},
/turf/simulated/floor/tiled/steel_grid,
/area/constructionsite)
"Fe" = (
/obj/effect/floor_decal/industrial/warning,
/obj/effect/floor_decal/corner/orange{
	dir = 5
	},
/turf/simulated/floor/tiled/steel_grid,
/area/constructionsite)
"Gj" = (
/obj/machinery/light/spot{
	dir = 8
	},
/obj/effect/floor_decal/corner/orange{
	dir = 9
	},
/turf/simulated/floor/tiled/steel_grid,
/area/constructionsite)
"Hk" = (
/turf/space,
/area/space)
"Iv" = (
/obj/effect/floor_decal/corner/orange/mono,
/obj/machinery/teleport/hub,
/turf/simulated/floor/tiled/monotile,
/area/constructionsite)
"JG" = (
/obj/effect/floor_decal/corner/orange{
	dir = 9
	},
/turf/simulated/floor/tiled/steel_grid,
/area/constructionsite)
"JO" = (
/obj/effect/wallframe_spawn/reinforced/titanium,
/turf/simulated/floor/plating,
/area/shuttle/escape)
"La" = (
/obj/structure/bed/chair{
	dir = 1
	},
/obj/machinery/embedded_controller/radio/simple_docking_controller{
	dir = 8;
	id_tag = "example_shuttle_starboard";
	pixel_x = 19;
	tag_door = "example_shuttle_starboard_hatch"
	},
/obj/machinery/embedded_controller/radio/simple_docking_controller{
	dir = 4;
	id_tag = "example_shuttle_port";
	pixel_x = -19;
	tag_door = "example_shuttle_port_hatch"
	},
/obj/effect/shuttle_landmark/lower_level,
/turf/simulated/floor/plating,
/area/shuttle/escape)
"Mo" = (
/obj/machinery/light/spot{
	dir = 4
	},
/obj/effect/floor_decal/corner/orange{
	dir = 6
	},
/turf/simulated/floor/tiled/steel_grid,
/area/constructionsite)
"Nu" = (
/obj/structure/table/rack,
/obj/item/gun/projectile/shotgun/pump,
/obj/item/gun/projectile/shotgun/pump,
/obj/item/gun/projectile/shotgun/pump,
/turf/simulated/floor/tiled/steel_grid,
/area/constructionsite)
"NQ" = (
/obj/effect/floor_decal/corner/orange{
	dir = 6
	},
/turf/simulated/floor/tiled/steel_grid,
/area/constructionsite)
"Pw" = (
/obj/structure/cable{
	d2 = 2;
	icon_state = "0-2"
	},
/obj/machinery/power/apc{
	dir = 8;
	name = "west bump";
	pixel_x = -24
	},
/obj/effect/floor_decal/corner/orange{
	dir = 9
	},
/turf/simulated/floor/tiled/steel_grid,
/area/constructionsite)
"PA" = (
/obj/effect/floor_decal/industrial/warning/corner{
	dir = 4
	},
/turf/simulated/floor/tiled/steel_grid,
/area/constructionsite)
"QF" = (
/obj/machinery/atmospherics/portables_connector{
	dir = 8
	},
/obj/machinery/portable_atmospherics/canister/air,
/obj/effect/floor_decal/corner/orange/mono,
/turf/simulated/floor/tiled/monotile,
/area/constructionsite)
"RW" = (
/obj/machinery/light/spot{
	dir = 1
	},
/obj/effect/floor_decal/corner/orange{
	dir = 5
	},
/turf/simulated/floor/tiled/steel_grid,
/area/constructionsite)
"Su" = (
/obj/machinery/door/airlock/external/bolted{
	id_tag = "example_shuttle_starboard_hatch"
	},
/turf/simulated/floor/plating,
/area/shuttle/escape)
"Sv" = (
/obj/effect/floor_decal/industrial/warning{
	dir = 1
	},
/turf/simulated/floor/tiled/steel_grid,
/area/constructionsite)
"Vt" = (
/turf/simulated/floor/plating,
/area/constructionsite)
"VY" = (
/obj/machinery/atmospherics/pipe/simple/hidden{
	dir = 4
	},
/obj/machinery/door/airlock/external/bolted{
	id_tag = "lower_level_dock_hatch_internal"
	},
/obj/machinery/button/access/interior{
	id_tag = "lower_level_dock";
	pixel_y = -21
	},
/turf/simulated/floor,
/area/constructionsite)
"Wr" = (
/obj/effect/floor_decal/industrial/warning/fulltile,
/obj/effect/floor_decal/industrial/warning{
	dir = 8
	},
/turf/simulated/floor/tiled,
/area/constructionsite)
"WF" = (
/obj/machinery/atmospherics/pipe/simple/hidden{
	dir = 5
	},
/turf/simulated/floor/tiled/steel_grid,
/area/constructionsite)
"Yo" = (
/obj/machinery/atmospherics/pipe/manifold/hidden{
	dir = 1
	},
/turf/simulated/floor/tiled/steel_grid,
/area/constructionsite)
"Yp" = (
/obj/effect/floor_decal/corner/orange{
	dir = 5
	},
/obj/machinery/teleport/station,
/turf/simulated/floor/tiled/steel_grid,
/area/constructionsite)
"Zi" = (
/obj/effect/floor_decal/corner/orange{
	dir = 10
	},
/turf/simulated/floor/tiled/steel_grid,
/area/constructionsite)
"ZF" = (
/obj/structure/cable{
	d1 = 1;
	d2 = 2;
	icon_state = "1-2"
	},
/obj/effect/floor_decal/corner/orange{
	dir = 9
	},
/turf/simulated/floor/tiled/steel_grid,
/area/constructionsite)
"ZW" = (
/obj/machinery/light/spot,
/obj/effect/floor_decal/corner/orange{
	dir = 10
	},
/turf/simulated/floor/tiled/steel_grid,
/area/constructionsite)

(1,1,1) = {"
Hk
Hk
Hk
Hk
Hk
Hk
Hk
Hk
Hk
Hk
Hk
Hk
Hk
Hk
Hk
Hk
Hk
Hk
Hk
Hk
Hk
Hk
Hk
Hk
Hk
Hk
Hk
Hk
Hk
Hk
Hk
Hk
"}
(2,1,1) = {"
Hk
Hk
Hk
Hk
Hk
Hk
Hk
Hk
Hk
Hk
Hk
Hk
Hk
Hk
Hk
Hk
Hk
Hk
Hk
Hk
Hk
Hk
Hk
Hk
Hk
Hk
Hk
Hk
Hk
Hk
Hk
Hk
"}
(3,1,1) = {"
Hk
Hk
Hk
Hk
Hk
Hk
Hk
Hk
Hk
Hk
Hk
Hk
Hk
Hk
Hk
Hk
Hk
Hk
Hk
Hk
Hk
Hk
Hk
Hk
Hk
Hk
Hk
Hk
Hk
Hk
Hk
Hk
"}
(4,1,1) = {"
Hk
Hk
Hk
Hk
Hk
Hk
Hk
Hk
Hk
Hk
Hk
Hk
Hk
Hk
Hk
Hk
Hk
Hk
Hk
Hk
Hk
Hk
Hk
Hk
Hk
Hk
Hk
Hk
Hk
Hk
Hk
Hk
"}
(5,1,1) = {"
Hk
Hk
Hk
Hk
Hk
Hk
Hk
Hk
Hk
Hk
Hk
Hk
Hk
Hk
Hk
Hk
Hk
Hk
Hk
Hk
Hk
Hk
Hk
Hk
Hk
Hk
Hk
Hk
Hk
Hk
Hk
Hk
"}
(6,1,1) = {"
Hk
Hk
Hk
Hk
Hk
Hk
Hk
Hk
Hk
Hk
Hk
Hk
Hk
Hk
Hk
Hk
Hk
Hk
Hk
Hk
Hk
Hk
Hk
Hk
Hk
Hk
Hk
Hk
Hk
Hk
Hk
Hk
"}
(7,1,1) = {"
Hk
Hk
Hk
Hk
Hk
Hk
Hk
Hk
Hk
Hk
Hk
Hk
Hk
Hk
Hk
Hk
Hk
Hk
Hk
Hk
Hk
Hk
Hk
Hk
Hk
Hk
Hk
Hk
Hk
Hk
Hk
Hk
"}
(8,1,1) = {"
Hk
Hk
Hk
Hk
Hk
Hk
Hk
Hk
Hk
Hk
Hk
Hk
Hk
Hk
Hk
Hk
Hk
Hk
Hk
Hk
Hk
Hk
Hk
Hk
Hk
Hk
Hk
Hk
Hk
Hk
Hk
Hk
"}
(9,1,1) = {"
Hk
Hk
Hk
Hk
Hk
Hk
Hk
Hk
Hk
Hk
Hk
Hk
Hk
Hk
Hk
Hk
Hk
Hk
Hk
Hk
Hk
Hk
Hk
Hk
Hk
Hk
Hk
Hk
Hk
Hk
Hk
Hk
"}
(10,1,1) = {"
Hk
Hk
Hk
Hk
Hk
Hk
Hk
Hk
Hk
Hk
Hk
Hk
Hk
Hk
Hk
Hk
Hk
Hk
Hk
Hk
Hk
Hk
Hk
Hk
Hk
Hk
Hk
Hk
Hk
Hk
Hk
Hk
"}
(11,1,1) = {"
Hk
Hk
Hk
Hk
Hk
Hk
Hk
Hk
Hk
Hk
Hk
Hk
Hk
Hk
Hk
Hk
Hk
Hk
Hk
Hk
Hk
Hk
Hk
Hk
Hk
Hk
Hk
Hk
Hk
Hk
Hk
Hk
"}
(12,1,1) = {"
Hk
Hk
Hk
Hk
Hk
Hk
Hk
Hk
Hk
Hk
Hk
Hk
Hk
Hk
Hk
Hk
Hk
Hk
Hk
Hk
Hk
Hk
Hk
Hk
Hk
Hk
Hk
Hk
Hk
Hk
Hk
Hk
"}
(13,1,1) = {"
Hk
Hk
Hk
Hk
Hk
Hk
Hk
Hk
Hk
Hk
Hk
Hk
Hk
Hk
Hk
xk
JO
JO
jg
xk
Hk
Hk
Hk
Hk
Hk
Hk
Hk
Hk
Hk
Hk
Hk
Hk
"}
(14,1,1) = {"
Hk
Hk
Hk
Hk
Hk
Hk
Hk
Hk
Hk
Hk
Hk
Hk
Hk
Hk
Hk
xk
cV
La
sT
xk
Hk
Hk
Hk
Hk
Hk
Hk
Hk
Hk
Hk
Hk
Hk
Hk
"}
(15,1,1) = {"
Hk
Hk
Hk
Hk
Hk
Hk
Hk
Hk
Hk
Hk
Hk
Hk
Hk
Hk
Hk
xk
JO
JO
Su
xk
Hk
Hk
Hk
Hk
Hk
Hk
Hk
Hk
Hk
Hk
Hk
Hk
"}
(16,1,1) = {"
Hk
Hk
Hk
Hk
Hk
Hk
Hk
fU
fU
fU
fU
fU
fU
fU
fU
fU
fU
eg
fQ
eg
fU
fU
fU
fU
fU
fU
Hk
Hk
Hk
Hk
Hk
Hk
"}
(17,1,1) = {"
Hk
Hk
Hk
Hk
Hk
Hk
Hk
fU
fU
fU
fU
fU
fU
fU
fU
fU
fU
eg
hw
eg
fU
fU
fU
fU
fU
fU
Hk
Hk
Hk
Hk
Hk
Hk
"}
(18,1,1) = {"
Hk
Hk
Hk
Hk
Hk
Hk
Hk
fU
fU
eg
eg
eg
eg
eg
eg
eg
eg
eg
VY
eg
eg
eg
eg
eg
fU
fU
Hk
Hk
Hk
Hk
Hk
Hk
"}
(19,1,1) = {"
Hk
Hk
Hk
Hk
Hk
Hk
Hk
fU
fU
eg
wF
JG
JG
Gj
JG
JG
tg
sQ
rY
Gj
Pw
ZF
oZ
eg
fU
fU
Hk
Hk
Hk
Hk
Hk
Hk
"}
(20,1,1) = {"
Hk
Hk
Hk
Hk
Hk
Hk
Hk
fU
fU
eg
EO
qJ
qJ
qJ
qJ
qJ
qJ
qJ
qJ
us
us
us
Zi
eg
fU
fU
Hk
Hk
Hk
Hk
Hk
Hk
"}
(21,1,1) = {"
Hk
Hk
Hk
Hk
Hk
Hk
Hk
fU
fU
eg
EO
qJ
qJ
qJ
vd
WF
qJ
fT
iM
us
us
us
Zi
eg
fU
fU
Hk
Hk
Hk
Hk
Hk
Hk
"}
(22,1,1) = {"
Hk
Hk
Hk
Hk
Hk
Hk
Hk
fU
fU
eg
RW
qJ
qJ
qJ
qJ
wB
qJ
wB
qJ
us
us
us
ZW
eg
fU
fU
Hk
Hk
Hk
Hk
Hk
Hk
"}
(23,1,1) = {"
Hk
Hk
Hk
Hk
Hk
Hk
Hk
fU
fU
eg
qt
tE
tE
jV
PA
wB
qJ
wB
qJ
qJ
qJ
qJ
Zi
eg
fU
fU
Hk
Hk
Hk
Hk
Hk
Hk
"}
(24,1,1) = {"
Hk
Hk
Hk
Hk
Hk
Hk
Hk
fU
fU
eg
Fe
Vt
Vt
xF
Sv
wB
qJ
wB
qJ
qJ
qJ
gO
Zi
eg
fU
fU
Hk
Hk
Hk
Hk
Hk
Hk
"}
(25,1,1) = {"
Hk
Hk
Hk
Hk
Hk
Hk
Hk
fU
fU
eg
Fe
Vt
Vt
Vt
Sv
wB
Bv
wB
qJ
qJ
qJ
cS
Zi
eg
fU
fU
Hk
Hk
Hk
Hk
Hk
Hk
"}
(26,1,1) = {"
Hk
Hk
Hk
Hk
Hk
Hk
Hk
fU
fU
eg
Fe
Vt
Vt
Vt
Sv
wB
qJ
wB
qJ
qJ
qJ
ck
Zi
eg
fU
fU
Hk
Hk
Hk
Hk
Hk
Hk
"}
(27,1,1) = {"
Hk
Hk
Hk
Hk
Hk
Hk
Hk
fU
fU
eg
yN
Wr
Wr
Wr
jO
wB
qJ
wB
qJ
qJ
qJ
jB
Zi
eg
fU
fU
Hk
Hk
Hk
Hk
Hk
Hk
"}
(28,1,1) = {"
Hk
Hk
Hk
Hk
Hk
Hk
Hk
fU
fU
eg
RW
qJ
qJ
qJ
qJ
wB
qJ
wB
qJ
qJ
qJ
tq
ZW
eg
fU
fU
Hk
Hk
Hk
Hk
Hk
Hk
"}
(29,1,1) = {"
Hk
Hk
Hk
Hk
Hk
Hk
Hk
fU
fU
eg
pm
qJ
qJ
qJ
vd
Af
qJ
Yo
iM
qJ
qJ
se
Zi
eg
fU
fU
Hk
Hk
Hk
Hk
Hk
Hk
"}
(30,1,1) = {"
Hk
Hk
Hk
Hk
Hk
Hk
Hk
fU
fU
eg
Yp
qJ
qJ
qJ
wj
wB
qJ
wB
qJ
qJ
qJ
Nu
Zi
eg
fU
fU
Hk
Hk
Hk
Hk
Hk
Hk
"}
(31,1,1) = {"
Hk
Hk
Hk
Hk
Hk
Hk
Hk
fU
fU
eg
Iv
NQ
kw
Mo
NQ
QF
NQ
BV
NQ
Mo
NQ
NQ
wF
eg
fU
fU
Hk
Hk
Hk
Hk
Hk
Hk
"}
(32,1,1) = {"
Hk
Hk
Hk
Hk
Hk
Hk
Hk
fU
fU
eg
eg
eg
eg
eg
eg
eg
eg
eg
eg
eg
eg
eg
eg
eg
fU
fU
Hk
Hk
Hk
Hk
Hk
Hk
"}
(33,1,1) = {"
Hk
Hk
Hk
Hk
Hk
Hk
Hk
fU
fU
fU
fU
fU
fU
fU
fU
fU
fU
fU
fU
fU
fU
fU
fU
fU
fU
fU
Hk
Hk
Hk
Hk
Hk
Hk
"}
(34,1,1) = {"
Hk
Hk
Hk
Hk
Hk
Hk
Hk
fU
fU
fU
fU
fU
fU
fU
fU
fU
fU
fU
fU
fU
fU
fU
fU
fU
fU
fU
Hk
Hk
Hk
Hk
Hk
Hk
"}
(35,1,1) = {"
Hk
Hk
Hk
Hk
Hk
Hk
Hk
Hk
Hk
Hk
Hk
Hk
Hk
Hk
Hk
Hk
Hk
Hk
Hk
Hk
Hk
Hk
Hk
Hk
Hk
Hk
Hk
Hk
Hk
Hk
Hk
Hk
"}
(36,1,1) = {"
Hk
Hk
Hk
Hk
Hk
Hk
Hk
Hk
Hk
Hk
Hk
Hk
Hk
Hk
Hk
Hk
Hk
Hk
Hk
Hk
Hk
Hk
Hk
Hk
Hk
Hk
Hk
Hk
Hk
Hk
Hk
Hk
"}
(37,1,1) = {"
Hk
Hk
Hk
Hk
Hk
Hk
Hk
Hk
Hk
Hk
Hk
Hk
Hk
Hk
Hk
Hk
Hk
Hk
Hk
Hk
Hk
Hk
Hk
Hk
Hk
Hk
Hk
Hk
Hk
Hk
Hk
Hk
"}
(38,1,1) = {"
Hk
Hk
Hk
Hk
Hk
Hk
Hk
Hk
Hk
Hk
Hk
Hk
Hk
Hk
Hk
Hk
Hk
Hk
Hk
Hk
Hk
Hk
Hk
Hk
Hk
Hk
Hk
Hk
Hk
Hk
Hk
Hk
"}
(39,1,1) = {"
Hk
Hk
Hk
Hk
Hk
Hk
Hk
Hk
Hk
Hk
Hk
Hk
Hk
Hk
Hk
Hk
Hk
Hk
Hk
Hk
Hk
Hk
Hk
Hk
Hk
Hk
Hk
Hk
Hk
Hk
Hk
Hk
"}
(40,1,1) = {"
Hk
Hk
Hk
Hk
Hk
Hk
Hk
Hk
Hk
Hk
Hk
Hk
Hk
Hk
Hk
Hk
Hk
Hk
Hk
Hk
Hk
Hk
Hk
Hk
Hk
Hk
Hk
Hk
Hk
Hk
Hk
Hk
"}
(41,1,1) = {"
Hk
Hk
Hk
Hk
Hk
Hk
Hk
Hk
Hk
Hk
Hk
Hk
Hk
Hk
Hk
Hk
Hk
Hk
Hk
Hk
Hk
Hk
Hk
Hk
Hk
Hk
Hk
Hk
Hk
Hk
Hk
Hk
"}
(42,1,1) = {"
Hk
Hk
Hk
Hk
Hk
Hk
Hk
Hk
Hk
Hk
Hk
Hk
Hk
Hk
Hk
Hk
Hk
Hk
Hk
Hk
Hk
Hk
Hk
Hk
Hk
Hk
Hk
Hk
Hk
Hk
Hk
Hk
"}
(43,1,1) = {"
Hk
Hk
Hk
Hk
Hk
Hk
Hk
Hk
Hk
Hk
Hk
Hk
Hk
Hk
Hk
Hk
Hk
Hk
Hk
Hk
Hk
Hk
Hk
Hk
Hk
Hk
Hk
Hk
Hk
Hk
Hk
Hk
"}
(44,1,1) = {"
Hk
Hk
Hk
Hk
Hk
Hk
Hk
Hk
Hk
Hk
Hk
Hk
Hk
Hk
Hk
Hk
Hk
Hk
Hk
Hk
Hk
Hk
Hk
Hk
Hk
Hk
Hk
Hk
Hk
Hk
Hk
Hk
"}
(45,1,1) = {"
Hk
Hk
Hk
Hk
Hk
Hk
Hk
Hk
Hk
Hk
Hk
Hk
Hk
Hk
Hk
Hk
Hk
Hk
Hk
Hk
Hk
Hk
Hk
Hk
Hk
Hk
Hk
Hk
Hk
Hk
Hk
Hk
"}
(46,1,1) = {"
Hk
Hk
Hk
Hk
Hk
Hk
Hk
Hk
Hk
Hk
Hk
Hk
Hk
Hk
Hk
Hk
Hk
Hk
Hk
Hk
Hk
Hk
Hk
Hk
Hk
Hk
Hk
Hk
Hk
Hk
Hk
Hk
"}
(47,1,1) = {"
Hk
Hk
Hk
Hk
Hk
Hk
Hk
Hk
Hk
Hk
Hk
Hk
Hk
Hk
Hk
Hk
Hk
Hk
Hk
Hk
Hk
Hk
Hk
Hk
Hk
Hk
Hk
Hk
Hk
Hk
Hk
Hk
"}
(48,1,1) = {"
Hk
Hk
Hk
Hk
Hk
Hk
Hk
Hk
Hk
Hk
Hk
Hk
Hk
Hk
Hk
Hk
Hk
Hk
Hk
Hk
Hk
Hk
Hk
Hk
Hk
Hk
Hk
Hk
Hk
Hk
Hk
Hk
"}
