//MAP CONVERTED BY dmm2tgm.py THIS HEADER COMMENT PREVENTS RECONVERSION, DO NOT REMOVE
"aj" = (
/obj/structure/table/glass,
/obj/item/chems/dropper,
/obj/item/stack/nanopaste,
/obj/effect/floor_decal/corner/blue/mono,
/obj/machinery/light/small{
	dir = 4
	},
/turf/floor/tiled/white/monotile,
/area/example/second)
"bU" = (
/obj/machinery/light{
	dir = 8
	},
/turf/floor/tiled/steel_ridged,
/area/example/second)
"cb" = (
/obj/effect/floor_decal/corner/mauve{
	dir = 5
	},
/turf/floor/tiled/white,
/area/example/second)
"cH" = (
/obj/machinery/optable,
/obj/effect/floor_decal/corner/blue/mono,
/turf/floor/tiled/white/monotile,
/area/example/second)
"dh" = (
/obj/machinery/design_database,
/obj/effect/floor_decal/corner/mauve/mono,
/turf/floor/tiled/white/monotile,
/area/example/second)
"dz" = (
/obj/machinery/atmospherics/pipe/simple/hidden{
	dir = 5
	},
/turf/floor,
/area/example/second)
"es" = (
/obj/machinery/light,
/turf/open,
/area/example/second)
"fJ" = (
/obj/machinery/light/small{
	dir = 1
	},
/obj/machinery/atmospherics/unary/vent_pump/high_volume/external_air{
	id_tag = "upper_level_dock_pump"
	},
/turf/floor,
/area/example/second)
"fS" = (
/obj/effect/floor_decal/industrial/warning/dust{
	dir = 4
	},
/obj/effect/floor_decal/corner/orange{
	dir = 9
	},
/turf/floor/tiled/steel_grid,
/area/example/second)
"fU" = (
/obj/effect/floor_decal/industrial/warning/dust,
/turf/floor,
/area/example/second)
"fX" = (
/obj/machinery/alarm{
	pixel_y = 24
	},
/turf/floor/tiled/steel_grid,
/area/example/second)
"gl" = (
/obj/machinery/atmospherics/pipe/simple/hidden{
	dir = 5
	},
/turf/floor/tiled/white,
/area/example/second)
"gs" = (
/obj/machinery/atmospherics/pipe/manifold/hidden{
	dir = 1
	},
/obj/structure/railing/mapped{
	dir = 1
	},
/turf/floor/tiled/white,
/area/example/second)
"hM" = (
/obj/machinery/light{
	dir = 8
	},
/turf/floor,
/area/example/second)
"ii" = (
/obj/machinery/door/airlock/external/bolted{
	id_tag = "upper_level_dock_hatch_internal"
	},
/turf/floor,
/area/example/second)
"iS" = (
/obj/machinery/atmospherics/pipe/simple/hidden{
	dir = 4
	},
/obj/machinery/alarm{
	dir = 1;
	pixel_y = -19
	},
/turf/floor/tiled/white,
/area/example/second)
"iY" = (
/obj/machinery/atmospherics/pipe/manifold/hidden,
/obj/structure/railing/mapped,
/turf/floor/tiled/white,
/area/example/second)
"jd" = (
/obj/machinery/atmospherics/pipe/simple/hidden{
	dir = 9
	},
/turf/floor/tiled/steel_grid,
/area/example/second)
"jr" = (
/obj/effect/floor_decal/industrial/warning/dust/corner{
	dir = 8
	},
/obj/effect/floor_decal/corner/orange{
	dir = 5
	},
/turf/floor/tiled/steel_grid,
/area/example/second)
"jW" = (
/obj/effect/floor_decal/industrial/warning{
	dir = 4
	},
/turf/floor/tiled/dark/monotile,
/area/example/second)
"kf" = (
/obj/machinery/fabricator/robotics,
/obj/effect/floor_decal/corner/mauve/mono,
/turf/floor/tiled/white/monotile,
/area/example/second)
"kx" = (
/obj/machinery/door/airlock/external/bolted{
	id_tag = "upper_level_dock_hatch_external"
	},
/obj/machinery/button/access/exterior{
	id_tag = "upper_level_dock";
	pixel_y = -24;
	dir = 4;
	pixel_x = 12;
	directional_offset = null
	},
/turf/floor,
/area/example/second)
"lm" = (
/obj/machinery/atmospherics/pipe/simple/hidden{
	dir = 4
	},
/turf/floor/tiled/white,
/area/example/second)
"ln" = (
/obj/effect/floor_decal/industrial/warning/dust/corner,
/obj/effect/floor_decal/corner/orange/three_quarters{
	dir = 8
	},
/turf/floor/tiled/steel_grid,
/area/example/second)
"lJ" = (
/turf/floor,
/area/example/second)
"lP" = (
/turf/floor/tiled/white,
/area/example/second)
"mC" = (
/obj/effect/floor_decal/corner/orange,
/turf/floor/tiled/steel_grid,
/area/example/second)
"nz" = (
/obj/machinery/light{
	dir = 1
	},
/turf/floor/tiled/steel_grid,
/area/example/second)
"nB" = (
/obj/effect/shuttle_landmark/upper_level,
/turf/open,
/area/space)
"nC" = (
/obj/effect/floor_decal/corner/mauve/mono,
/obj/effect/floor_decal/industrial/outline/yellow,
/obj/machinery/light/small{
	dir = 4
	},
/turf/floor/tiled/white/monotile,
/area/example/second)
"nO" = (
/obj/machinery/atmospherics/unary/vent_pump/on,
/turf/floor/tiled/white,
/area/example/second)
"oi" = (
/obj/structure/tank_rack/oxygen,
/obj/machinery/light,
/turf/floor/tiled/dark/monotile,
/area/example/second)
"oC" = (
/obj/machinery/suit_cycler/engineering/prepared,
/turf/floor/tiled/dark/monotile,
/area/example/second)
"oI" = (
/obj/machinery/light,
/turf/floor/tiled/steel_grid,
/area/example/second)
"oS" = (
/turf/open,
/area/space)
"pc" = (
/obj/effect/wallframe_spawn/reinforced,
/turf/floor/plating,
/area/example/second)
"pk" = (
/obj/machinery/light{
	dir = 1
	},
/turf/floor,
/area/example/second)
"pr" = (
/obj/machinery/computer/operating{
	dir = 1
	},
/obj/effect/floor_decal/corner/blue/mono,
/turf/floor/tiled/white/monotile,
/area/example/second)
"ps" = (
/obj/machinery/atmospherics/unary/vent_pump/high_volume/external_air{
	id_tag = "upper_level_dock_pump"
	},
/obj/machinery/airlock_sensor{
	id_tag = "upper_level_dock_sensor_chamber";
	pixel_x = 22;
	dir = 8
	},
/obj/machinery/embedded_controller/radio/airlock/docking_port{
	id_tag = "upper_level_dock";
	pixel_y = 24;
	tag_airpump = "upper_level_dock_pump";
	tag_chamber_sensor = "upper_level_dock_sensor_chamber";
	tag_exterior_door = "upper_level_dock_hatch_external";
	tag_interior_door = "upper_level_dock_hatch_internal"
	},
/turf/floor,
/area/example/second)
"pt" = (
/obj/effect/floor_decal/industrial/warning/dust/corner{
	dir = 4
	},
/obj/effect/floor_decal/corner/orange/three_quarters,
/turf/floor/tiled/steel_grid,
/area/example/second)
"qk" = (
/obj/structure/railing/mapped{
	dir = 8
	},
/turf/floor/tiled/white,
/area/example/second)
"qA" = (
/obj/effect/floor_decal/industrial/warning/dust,
/obj/effect/floor_decal/corner/orange{
	dir = 5
	},
/turf/floor/tiled/steel_grid,
/area/example/second)
"qV" = (
/obj/machinery/light{
	dir = 8
	},
/turf/floor/tiled/steel_grid,
/area/example/second)
"qW" = (
/obj/machinery/atmospherics/portables_connector,
/obj/machinery/portable_atmospherics/canister/air,
/obj/effect/floor_decal/industrial/outline/blue,
/obj/machinery/light{
	dir = 4
	},
/turf/floor/tiled/dark/monotile,
/area/example/second)
"rb" = (
/obj/effect/floor_decal/corner/blue/mono,
/obj/machinery/sleeper/standard,
/turf/floor/tiled/white/monotile,
/area/example/second)
"rn" = (
/obj/machinery/door/airlock,
/turf/floor/tiled/steel_ridged,
/area/example/second)
"sA" = (
/turf/floor/tiled/steel_ridged,
/area/example/second)
"sO" = (
/obj/machinery/door/airlock/external/bolted{
	id_tag = "upper_level_dock_hatch_internal"
	},
/obj/machinery/atmospherics/pipe/simple/hidden,
/turf/floor,
/area/example/second)
"sT" = (
/obj/effect/floor_decal/corner/mauve{
	dir = 5
	},
/obj/machinery/atmospherics/pipe/simple/hidden{
	dir = 6
	},
/turf/floor/tiled/white,
/area/example/second)
"sV" = (
/obj/machinery/atmospherics/pipe/simple/hidden,
/obj/machinery/button/access/interior{
	id_tag = "upper_level_dock";
	pixel_x = 24;
	pixel_y = 24
	},
/turf/floor/tiled/steel_grid,
/area/example/second)
"sY" = (
/obj/effect/floor_decal/industrial/warning/dust{
	dir = 4
	},
/obj/effect/floor_decal/corner/orange{
	dir = 9
	},
/obj/machinery/light/small{
	dir = 8
	},
/turf/floor/tiled/steel_grid,
/area/example/second)
"ug" = (
/obj/abstract/level_data_spawner/main_level{
	name = "Example Second Deck"
	},
/turf/space,
/area/space)
"uk" = (
/obj/effect/floor_decal/industrial/warning/dust{
	dir = 8
	},
/obj/machinery/atmospherics/pipe/simple/hidden{
	dir = 4
	},
/turf/floor/tiled/steel_grid,
/area/example/second)
"un" = (
/obj/machinery/light{
	dir = 4
	},
/turf/floor,
/area/example/second)
"uF" = (
/obj/effect/floor_decal/industrial/warning/dust{
	dir = 8
	},
/turf/floor/tiled/steel_grid,
/area/example/second)
"wP" = (
/turf/open,
/area/example/second)
"xk" = (
/obj/machinery/light{
	dir = 4
	},
/turf/open,
/area/example/second)
"xs" = (
/turf/space,
/area/space)
"xD" = (
/obj/effect/floor_decal/corner/orange{
	dir = 10
	},
/turf/floor/tiled/steel_grid,
/area/example/second)
"xX" = (
/obj/machinery/light{
	dir = 4
	},
/turf/floor/tiled/steel_grid,
/area/example/second)
"ys" = (
/obj/structure/table/glass,
/obj/item/box/syringes,
/obj/item/box/freezer,
/obj/effect/floor_decal/corner/blue/mono,
/turf/floor/tiled/white/monotile,
/area/example/second)
"yy" = (
/obj/structure/railing/mapped{
	dir = 4
	},
/turf/floor/tiled/white,
/area/example/second)
"yE" = (
/turf/floor/tiled/dark/monotile,
/area/example/second)
"zG" = (
/obj/effect/floor_decal/industrial/warning/dust/corner{
	dir = 1
	},
/obj/effect/floor_decal/corner/orange{
	dir = 10
	},
/turf/floor/tiled/steel_grid,
/area/example/second)
"Am" = (
/obj/machinery/light,
/turf/floor,
/area/example/second)
"Ba" = (
/obj/effect/floor_decal/corner/orange{
	dir = 9
	},
/obj/machinery/light{
	dir = 8
	},
/turf/floor/tiled/steel_grid,
/area/example/second)
"BG" = (
/obj/machinery/light/small{
	dir = 8
	},
/turf/floor/tiled/white,
/area/example/second)
"BY" = (
/obj/effect/floor_decal/industrial/warning/dust{
	dir = 1
	},
/obj/effect/floor_decal/corner/orange{
	dir = 10
	},
/turf/floor/tiled/steel_grid,
/area/example/second)
"Ci" = (
/obj/machinery/power/debug_items/infinite_generator,
/obj/structure/cable/yellow,
/turf/floor/tiled/white,
/area/example/second)
"Cq" = (
/obj/machinery/light_switch/on{
	dir = 1;
	pixel_y = -20
	},
/turf/floor/tiled/white,
/area/example/second)
"Cu" = (
/obj/effect/floor_decal/corner/orange{
	dir = 6
	},
/turf/floor/tiled/steel_grid,
/area/example/second)
"CN" = (
/obj/effect/floor_decal/corner/mauve{
	dir = 5
	},
/obj/machinery/atmospherics/pipe/simple/hidden{
	dir = 4
	},
/turf/floor/tiled/white,
/area/example/second)
"CW" = (
/turf/floor/tiled/steel_grid,
/area/example/second)
"CX" = (
/obj/structure/cable/yellow{
	icon_state = "1-2"
	},
/turf/floor/tiled/white,
/area/example/second)
"Dt" = (
/obj/effect/floor_decal/corner/blue/mono,
/obj/structure/closet/secure_closet/freezer/meat,
/turf/floor/tiled/white/monotile,
/area/example/second)
"En" = (
/obj/machinery/bodyscanner{
	dir = 1
	},
/obj/effect/floor_decal/corner/blue/mono,
/turf/floor/tiled/white/monotile,
/area/example/second)
"EO" = (
/obj/machinery/fabricator/protolathe,
/obj/effect/floor_decal/corner/mauve/mono,
/turf/floor/tiled/white/monotile,
/area/example/second)
"FE" = (
/obj/effect/floor_decal/corner/orange{
	dir = 10
	},
/obj/effect/floor_decal/industrial/warning{
	dir = 4
	},
/turf/floor/tiled/steel_grid,
/area/example/second)
"Gn" = (
/obj/effect/wallframe_spawn/reinforced,
/turf/floor,
/area/example/second)
"Gy" = (
/obj/effect/floor_decal/corner/orange/three_quarters{
	dir = 8
	},
/turf/floor/tiled/steel_grid,
/area/example/second)
"GG" = (
/obj/structure/railing/mapped,
/turf/open,
/area/example/second)
"GP" = (
/obj/machinery/light{
	dir = 4
	},
/obj/machinery/atmospherics/portables_connector{
	dir = 1
	},
/obj/machinery/portable_atmospherics/canister/empty,
/obj/effect/floor_decal/industrial/outline/red,
/turf/floor/tiled/dark/monotile,
/area/example/second)
"Hn" = (
/obj/structure/table/glass,
/obj/item/box/gloves,
/obj/item/box/masks,
/obj/effect/floor_decal/corner/blue/mono,
/turf/floor/tiled/white/monotile,
/area/example/second)
"Hp" = (
/obj/structure/grille,
/turf/space,
/area/space)
"JU" = (
/obj/structure/table/glass,
/obj/item/scalpel/laser,
/obj/item/scalpel/laser/upgraded,
/obj/item/scalpel/laser/advanced,
/obj/item/robotanalyzer,
/obj/item/scanner/health,
/obj/item/firstaid/adv,
/obj/effect/floor_decal/corner/blue/mono,
/turf/floor/tiled/white/monotile,
/area/example/second)
"Lq" = (
/obj/structure/stairs{
	dir = 1
	},
/turf/floor/tiled/white,
/area/example/second)
"Lz" = (
/obj/machinery/atmospherics/unary/vent_scrubber/on{
	dir = 1
	},
/turf/floor/tiled/white,
/area/example/second)
"LK" = (
/obj/structure/table/glass,
/obj/item/firstaid/surgery,
/obj/effect/floor_decal/corner/blue/mono,
/turf/floor/tiled/white/monotile,
/area/example/second)
"LX" = (
/obj/machinery/fabricator/imprinter,
/obj/effect/floor_decal/corner/mauve/mono,
/turf/floor/tiled/white/monotile,
/area/example/second)
"Nj" = (
/obj/effect/floor_decal/industrial/warning/dust{
	dir = 1
	},
/obj/effect/floor_decal/corner/orange{
	dir = 10
	},
/obj/machinery/light/small,
/turf/floor/tiled/steel_grid,
/area/example/second)
"Ny" = (
/obj/machinery/atmospherics/pipe/manifold/hidden{
	dir = 4
	},
/turf/floor,
/area/example/second)
"NY" = (
/obj/structure/ladder,
/turf/open,
/area/example/second)
"Pc" = (
/obj/effect/floor_decal/corner/orange{
	dir = 5
	},
/turf/floor/tiled/steel_grid,
/area/example/second)
"Qn" = (
/obj/machinery/destructive_analyzer,
/obj/effect/floor_decal/corner/mauve/mono,
/turf/floor/tiled/white/monotile,
/area/example/second)
"QJ" = (
/obj/effect/floor_decal/corner/orange{
	dir = 6
	},
/obj/machinery/light{
	dir = 4
	},
/turf/floor/tiled/steel_grid,
/area/example/second)
"QU" = (
/obj/structure/rack,
/obj/item/stack/material/sheet/reinforced/mapped/plasteel/fifty,
/obj/item/stack/material/ingot/mapped/copper/fifty,
/obj/item/stack/material/sheet/mapped/steel/fifty,
/obj/item/stack/material/pane/mapped/glass/fifty,
/obj/item/stack/material/sheet/reinforced/mapped/fiberglass/fifty,
/obj/item/stack/material/ingot/mapped/gold/ten,
/obj/item/stack/material/segment/mapped/mhydrogen/ten,
/obj/item/stack/material/ingot/mapped/silver/ten,
/obj/item/stack/material/puck/mapped/uranium/ten,
/obj/item/stack/material/gemstone/mapped/diamond/ten,
/obj/item/belt/utility/full,
/obj/item/stack/material/sheet/mapped/steel/fifty,
/obj/effect/floor_decal/corner/blue/mono,
/turf/floor/tiled/white/monotile,
/area/example/second)
"SQ" = (
/obj/machinery/atmospherics/pipe/simple/hidden{
	dir = 10
	},
/turf/floor/tiled/steel_grid,
/area/example/second)
"Uf" = (
/obj/effect/floor_decal/corner/orange/three_quarters{
	dir = 4
	},
/turf/floor/tiled/steel_grid,
/area/example/second)
"UN" = (
/obj/machinery/computer/design_console{
	dir = 1
	},
/obj/effect/floor_decal/corner/mauve/mono,
/turf/floor/tiled/white/monotile,
/area/example/second)
"Vm" = (
/obj/effect/floor_decal/industrial/warning/dust{
	dir = 4
	},
/turf/floor,
/area/example/second)
"VG" = (
/obj/machinery/fabricator/bioprinter,
/obj/effect/floor_decal/corner/blue/mono,
/turf/floor/tiled/white/monotile,
/area/example/second)
"VL" = (
/turf/open,
/area/turbolift/example/second)
"WW" = (
/obj/effect/floor_decal/corner/mauve/mono,
/obj/machinery/recycler,
/turf/floor/tiled/white/monotile,
/area/example/second)
"Xm" = (
/obj/structure/iv_drip,
/obj/item/chems/ivbag/blood/ominus,
/obj/item/chems/ivbag/blood/ominus,
/obj/item/chems/ivbag/blood/ominus,
/obj/effect/floor_decal/corner/blue/mono,
/turf/floor/tiled/white/monotile,
/area/example/second)
"Xw" = (
/obj/machinery/light/small{
	dir = 4
	},
/turf/open,
/area/example/second)
"XE" = (
/turf/wall/r_wall/prepainted,
/area/example/second)
"XR" = (
/obj/effect/floor_decal/corner/orange{
	dir = 9
	},
/turf/floor/tiled/steel_grid,
/area/example/second)
"Yn" = (
/obj/machinery/fabricator/industrial,
/obj/effect/floor_decal/corner/mauve/mono,
/turf/floor/tiled/white/monotile,
/area/example/second)
"Yy" = (
/turf/floor/shuttle_ceiling,
/area/space)
"YT" = (
/obj/effect/floor_decal/corner/mauve{
	dir = 1
	},
/obj/machinery/atmospherics/pipe/simple/hidden{
	dir = 4
	},
/obj/machinery/power/apc{
	dir = 1;
	pixel_y = 21
	},
/obj/structure/cable/yellow{
	icon_state = "0-2"
	},
/turf/floor/tiled/white,
/area/example/second)
"ZD" = (
/obj/machinery/body_scanconsole{
	dir = 1
	},
/obj/effect/floor_decal/corner/blue/mono,
/turf/floor/tiled/white/monotile,
/area/example/second)
"ZI" = (
/obj/machinery/atmospherics/portables_connector{
	dir = 1
	},
/obj/machinery/portable_atmospherics/canister/air/airlock,
/turf/floor/tiled/dark/monotile,
/area/example/second)

(1,1,1) = {"
xs
xs
xs
xs
xs
xs
xs
xs
xs
xs
xs
xs
xs
xs
xs
xs
xs
xs
xs
xs
xs
xs
xs
xs
xs
xs
xs
xs
xs
xs
xs
xs
xs
xs
xs
xs
xs
xs
xs
xs
xs
xs
xs
xs
xs
xs
xs
xs
xs
xs
xs
ug
"}
(2,1,1) = {"
xs
xs
xs
xs
xs
xs
xs
xs
xs
xs
xs
xs
xs
xs
xs
xs
xs
xs
xs
xs
xs
xs
xs
xs
xs
xs
xs
xs
xs
xs
xs
xs
xs
xs
xs
xs
xs
xs
xs
xs
xs
xs
xs
xs
xs
xs
xs
xs
xs
xs
xs
xs
"}
(3,1,1) = {"
xs
xs
xs
xs
xs
xs
xs
xs
xs
xs
xs
xs
xs
xs
xs
xs
xs
xs
xs
xs
xs
xs
xs
xs
xs
xs
xs
xs
xs
xs
xs
xs
xs
xs
xs
xs
xs
xs
xs
xs
xs
xs
xs
xs
xs
xs
xs
xs
xs
xs
xs
xs
"}
(4,1,1) = {"
xs
xs
xs
xs
xs
xs
xs
xs
xs
xs
xs
xs
xs
xs
xs
xs
xs
xs
xs
xs
xs
xs
xs
xs
xs
xs
xs
xs
xs
xs
xs
xs
xs
xs
xs
xs
xs
xs
xs
xs
xs
xs
xs
xs
xs
xs
xs
xs
xs
xs
xs
xs
"}
(5,1,1) = {"
xs
xs
xs
xs
xs
xs
xs
xs
xs
xs
xs
xs
xs
xs
xs
xs
xs
xs
xs
xs
xs
xs
xs
xs
xs
xs
xs
xs
xs
xs
xs
xs
xs
xs
xs
xs
xs
xs
xs
xs
xs
xs
xs
xs
xs
xs
xs
xs
xs
xs
xs
xs
"}
(6,1,1) = {"
xs
xs
xs
xs
xs
xs
xs
xs
xs
xs
xs
xs
xs
xs
xs
xs
xs
xs
xs
xs
xs
xs
xs
xs
xs
xs
xs
xs
xs
xs
xs
xs
xs
xs
xs
xs
xs
xs
xs
xs
xs
xs
xs
xs
xs
xs
xs
xs
xs
xs
xs
xs
"}
(7,1,1) = {"
xs
xs
xs
xs
xs
xs
xs
xs
xs
xs
xs
xs
xs
xs
xs
xs
xs
xs
xs
xs
xs
xs
xs
xs
xs
xs
xs
xs
xs
xs
xs
xs
xs
xs
xs
xs
xs
xs
xs
xs
xs
xs
xs
xs
xs
xs
xs
xs
xs
xs
xs
xs
"}
(8,1,1) = {"
xs
xs
xs
xs
xs
xs
xs
xs
xs
xs
xs
xs
xs
xs
xs
xs
xs
xs
xs
xs
xs
xs
xs
xs
xs
xs
xs
xs
xs
xs
xs
xs
xs
xs
xs
xs
xs
xs
xs
xs
xs
xs
xs
xs
xs
xs
xs
xs
xs
xs
xs
xs
"}
(9,1,1) = {"
xs
xs
xs
xs
xs
xs
xs
xs
oS
oS
oS
oS
oS
oS
oS
oS
oS
oS
oS
oS
oS
oS
oS
oS
oS
oS
oS
oS
oS
oS
oS
oS
oS
oS
oS
oS
oS
oS
oS
oS
oS
oS
oS
oS
xs
xs
xs
xs
xs
xs
xs
xs
"}
(10,1,1) = {"
xs
xs
xs
xs
xs
xs
xs
xs
oS
oS
oS
oS
oS
oS
oS
oS
oS
oS
oS
oS
oS
oS
oS
oS
oS
oS
oS
oS
oS
oS
oS
oS
oS
oS
oS
oS
oS
oS
oS
oS
oS
oS
oS
oS
xs
xs
xs
xs
xs
xs
xs
xs
"}
(11,1,1) = {"
xs
xs
xs
xs
xs
xs
xs
xs
oS
oS
XE
XE
XE
XE
XE
XE
XE
XE
XE
XE
pc
pc
pc
pc
pc
XE
XE
XE
XE
XE
XE
XE
XE
XE
XE
XE
XE
XE
XE
XE
XE
XE
oS
oS
xs
xs
xs
xs
xs
xs
xs
xs
"}
(12,1,1) = {"
xs
xs
xs
xs
xs
xs
xs
xs
oS
oS
XE
lJ
lJ
lJ
lJ
lJ
lJ
hM
lJ
lJ
lJ
lJ
lJ
lJ
lJ
hM
lJ
lJ
lJ
lJ
lJ
lJ
lJ
lJ
hM
lJ
lJ
lJ
lJ
lJ
lJ
XE
oS
oS
xs
xs
xs
xs
xs
xs
xs
xs
"}
(13,1,1) = {"
xs
xs
xs
xs
xs
xs
xs
xs
oS
oS
XE
lJ
XE
XE
XE
XE
XE
XE
XE
XE
sA
sA
sA
sA
sA
XE
XE
XE
XE
XE
XE
XE
XE
XE
XE
XE
XE
XE
XE
XE
lJ
XE
oS
oS
xs
xs
xs
xs
xs
xs
xs
xs
"}
(14,1,1) = {"
xs
xs
xs
xs
xs
xs
xs
xs
oS
oS
XE
lJ
XE
wP
wP
wP
CW
CW
rn
CW
CW
CW
CW
CW
CW
qV
sA
ln
fS
fS
sY
fS
fS
fS
fS
sY
fS
fS
pt
XE
lJ
XE
oS
oS
xs
xs
xs
xs
xs
xs
xs
xs
"}
(15,1,1) = {"
xs
xs
xs
xs
xs
xs
xs
xs
oS
oS
XE
lJ
XE
wP
xk
GG
CW
CW
XE
CW
CW
CW
CW
CW
CW
CW
sA
qA
En
ZD
lP
Xm
NY
lP
LX
cb
lP
dh
BY
XE
lJ
XE
oS
oS
xs
xs
xs
xs
xs
xs
xs
xs
"}
(16,1,1) = {"
xs
xs
xs
xs
xs
xs
xs
xs
oS
oS
XE
lJ
XE
XE
XE
XE
fX
oi
XE
CW
CW
CW
CW
CW
CW
CW
sA
qA
lP
nO
gl
cH
lP
lP
Qn
sT
Lz
dh
BY
XE
lJ
XE
oS
oS
xs
xs
xs
xs
xs
xs
xs
xs
"}
(17,1,1) = {"
xs
xs
xs
xs
xs
xs
xs
xs
oS
oS
XE
lJ
XE
fJ
dz
ii
CW
oC
XE
CW
CW
CW
CW
CW
CW
CW
sA
qA
LK
lP
lm
pr
lP
lP
EO
CN
lP
UN
Nj
XE
lJ
XE
oS
oS
xs
xs
xs
xs
xs
xs
xs
xs
"}
(18,1,1) = {"
xs
xs
xs
xs
xs
xs
xs
xs
oS
oS
XE
pk
XE
ps
Ny
sO
sV
ZI
XE
CW
xX
CW
CW
CW
CW
CW
sA
qA
Hn
lP
lm
JU
lP
lP
Yn
CN
lP
kf
BY
XE
Am
XE
oS
oS
xs
xs
xs
xs
xs
xs
xs
xs
"}
(19,1,1) = {"
xs
xs
xs
xs
xs
xs
xs
xs
oS
oS
XE
XE
XE
XE
kx
XE
pc
XE
XE
XE
XE
XE
XE
sA
sA
sA
XE
qA
ys
lP
lm
aj
lP
lP
nC
CN
lP
WW
BY
XE
lJ
XE
oS
oS
xs
xs
xs
xs
xs
xs
xs
xs
"}
(20,1,1) = {"
xs
xs
xs
xs
xs
xs
xs
xs
oS
oS
Hp
oS
oS
oS
oS
oS
oS
oS
XE
XR
Ba
XR
XE
nz
CW
CW
sA
qA
rb
lP
iS
XE
lP
Cq
XE
YT
CX
Ci
BY
XE
lJ
XE
oS
oS
xs
xs
xs
xs
xs
xs
xs
xs
"}
(21,1,1) = {"
xs
xs
xs
xs
xs
xs
xs
xs
oS
oS
Hp
oS
oS
oS
nB
oS
oS
oS
pc
CW
CW
CW
pc
CW
CW
CW
sA
qA
Dt
lP
lm
BG
lP
lP
BG
lm
lP
lP
BY
XE
lJ
XE
oS
oS
xs
xs
xs
xs
xs
xs
xs
xs
"}
(22,1,1) = {"
xs
xs
xs
xs
xs
xs
xs
xs
oS
oS
Hp
oS
oS
oS
oS
oS
oS
oS
pc
CW
CW
CW
sA
CW
CW
CW
sA
qA
QU
lP
lm
yy
lP
lP
yy
lm
lP
lP
Nj
XE
lJ
XE
oS
oS
xs
xs
xs
xs
xs
xs
xs
xs
"}
(23,1,1) = {"
xs
xs
xs
xs
xs
xs
xs
xs
oS
oS
Hp
oS
oS
oS
oS
oS
oS
oS
pc
CW
CW
CW
sA
CW
CW
CW
sA
qA
VG
nO
iY
Lq
lP
lP
wP
gs
Lz
lP
BY
XE
lJ
XE
oS
oS
xs
xs
xs
xs
xs
xs
xs
xs
"}
(24,1,1) = {"
xs
xs
xs
xs
xs
xs
xs
xs
oS
oS
Hp
oS
Yy
Yy
Yy
Yy
Yy
oS
pc
CW
CW
CW
sA
CW
CW
CW
sA
qA
lP
lP
lm
qk
lP
lP
qk
lm
lP
lP
BY
XE
lJ
XE
oS
oS
xs
xs
xs
xs
xs
xs
xs
xs
"}
(25,1,1) = {"
xs
xs
xs
xs
xs
xs
xs
xs
oS
oS
Hp
oS
Yy
Yy
Yy
Yy
Yy
oS
pc
CW
CW
CW
pc
CW
CW
CW
sA
jr
uF
uF
uk
uF
uF
uF
uF
uk
uF
uF
zG
XE
lJ
XE
oS
oS
xs
xs
xs
xs
xs
xs
xs
xs
"}
(26,1,1) = {"
xs
xs
xs
xs
xs
xs
xs
xs
oS
oS
Hp
oS
Yy
Yy
Yy
Yy
Yy
oS
XE
Cu
QJ
Cu
XE
nz
CW
CW
sA
NY
Cu
qW
jd
CW
CW
CW
CW
SQ
GP
Cu
Uf
XE
lJ
XE
oS
oS
xs
xs
xs
xs
xs
xs
xs
xs
"}
(27,1,1) = {"
xs
xs
xs
xs
xs
xs
xs
xs
oS
oS
XE
XE
XE
pc
pc
pc
pc
XE
XE
XE
XE
XE
XE
sA
sA
sA
XE
XE
XE
XE
sA
sA
sA
sA
sA
sA
XE
XE
XE
XE
Am
XE
oS
oS
xs
xs
xs
xs
xs
xs
xs
xs
"}
(28,1,1) = {"
xs
xs
xs
xs
xs
xs
xs
xs
oS
oS
XE
lJ
XE
CW
CW
CW
CW
CW
sA
CW
qV
CW
CW
CW
CW
CW
bU
Gy
XR
XR
CW
CW
CW
CW
CW
CW
XR
XR
XR
sA
lJ
XE
oS
oS
xs
xs
xs
xs
xs
xs
xs
xs
"}
(29,1,1) = {"
xs
xs
xs
xs
xs
xs
xs
xs
oS
oS
XE
lJ
XE
CW
CW
CW
CW
CW
sA
CW
CW
CW
CW
CW
CW
CW
sA
Pc
yE
yE
yE
yE
yE
yE
yE
yE
yE
yE
yE
sA
lJ
XE
oS
oS
xs
xs
xs
xs
xs
xs
xs
xs
"}
(30,1,1) = {"
xs
xs
xs
xs
xs
xs
xs
xs
oS
oS
XE
lJ
XE
CW
CW
CW
CW
CW
sA
CW
CW
CW
CW
CW
CW
CW
sA
Pc
yE
mC
Cu
Cu
Cu
Cu
Cu
Cu
Cu
Cu
Cu
sA
lJ
XE
oS
oS
xs
xs
xs
xs
xs
xs
xs
xs
"}
(31,1,1) = {"
xs
xs
xs
xs
xs
xs
xs
xs
oS
oS
XE
lJ
XE
CW
CW
CW
CW
CW
sA
CW
CW
CW
CW
CW
CW
CW
sA
Pc
yE
xD
Gn
Gn
Gn
Gn
Gn
Gn
Gn
Gn
Gn
XE
Vm
XE
oS
oS
xs
xs
xs
xs
xs
xs
xs
xs
"}
(32,1,1) = {"
xs
xs
xs
xs
xs
xs
xs
xs
oS
oS
XE
lJ
XE
nz
CW
CW
CW
oI
XE
CW
CW
CW
CW
CW
CW
CW
sA
Pc
yE
xD
Gn
wP
wP
wP
wP
wP
wP
wP
wP
wP
wP
XE
oS
oS
xs
xs
xs
xs
xs
xs
xs
xs
"}
(33,1,1) = {"
xs
xs
xs
xs
xs
xs
xs
xs
oS
oS
XE
lJ
XE
CW
CW
CW
CW
CW
XE
CW
CW
CW
CW
CW
CW
CW
sA
Pc
yE
xD
Gn
wP
wP
wP
wP
wP
wP
wP
wP
wP
wP
XE
oS
oS
xs
xs
xs
xs
xs
xs
xs
xs
"}
(34,1,1) = {"
xs
xs
xs
xs
xs
xs
xs
xs
oS
oS
XE
lJ
XE
CW
CW
CW
CW
CW
XE
CW
xX
CW
CW
CW
xX
CW
sA
Pc
yE
xD
Gn
wP
wP
wP
wP
wP
wP
wP
wP
wP
wP
XE
oS
oS
xs
xs
xs
xs
xs
xs
xs
xs
"}
(35,1,1) = {"
xs
xs
xs
xs
xs
xs
xs
xs
oS
oS
XE
pk
XE
CW
CW
CW
CW
CW
XE
XE
XE
sA
sA
sA
XE
XE
XE
NY
jW
FE
Gn
wP
wP
wP
wP
wP
wP
wP
wP
wP
es
XE
oS
oS
xs
xs
xs
xs
xs
xs
xs
xs
"}
(36,1,1) = {"
xs
xs
xs
xs
xs
xs
xs
xs
oS
oS
XE
lJ
XE
CW
CW
CW
CW
CW
XE
CW
qV
CW
CW
CW
qV
CW
XE
VL
VL
VL
Gn
wP
wP
wP
wP
wP
wP
wP
wP
wP
wP
XE
oS
oS
xs
xs
xs
xs
xs
xs
xs
xs
"}
(37,1,1) = {"
xs
xs
xs
xs
xs
xs
xs
xs
oS
oS
XE
lJ
XE
nz
CW
CW
CW
oI
XE
CW
CW
CW
CW
CW
CW
CW
XE
VL
VL
VL
Gn
wP
wP
wP
wP
wP
wP
wP
wP
wP
wP
XE
oS
oS
xs
xs
xs
xs
xs
xs
xs
xs
"}
(38,1,1) = {"
xs
xs
xs
xs
xs
xs
xs
xs
oS
oS
XE
lJ
XE
CW
CW
CW
CW
CW
XE
CW
CW
CW
CW
CW
CW
CW
XE
VL
VL
VL
Gn
wP
wP
wP
wP
wP
wP
wP
wP
wP
wP
XE
oS
oS
xs
xs
xs
xs
xs
xs
xs
xs
"}
(39,1,1) = {"
xs
xs
xs
xs
xs
xs
xs
xs
oS
oS
XE
lJ
XE
CW
CW
CW
CW
CW
XE
CW
CW
CW
CW
CW
CW
CW
XE
wP
Xw
wP
Gn
wP
wP
wP
wP
wP
wP
wP
wP
wP
wP
XE
oS
oS
xs
xs
xs
xs
xs
xs
xs
xs
"}
(40,1,1) = {"
xs
xs
xs
xs
xs
xs
xs
xs
oS
oS
XE
lJ
XE
XE
XE
XE
XE
XE
XE
XE
sA
sA
sA
sA
sA
XE
XE
XE
XE
XE
XE
wP
wP
wP
wP
wP
wP
wP
wP
wP
wP
XE
oS
oS
xs
xs
xs
xs
xs
xs
xs
xs
"}
(41,1,1) = {"
xs
xs
xs
xs
xs
xs
xs
xs
oS
oS
XE
lJ
lJ
lJ
lJ
lJ
lJ
un
lJ
lJ
lJ
lJ
lJ
lJ
lJ
un
lJ
lJ
lJ
lJ
fU
wP
wP
wP
xk
wP
wP
wP
wP
wP
wP
XE
oS
oS
xs
xs
xs
xs
xs
xs
xs
xs
"}
(42,1,1) = {"
xs
xs
xs
xs
xs
xs
xs
xs
oS
oS
XE
XE
XE
XE
XE
XE
XE
XE
XE
XE
XE
XE
XE
XE
XE
XE
XE
XE
XE
XE
XE
XE
XE
XE
XE
XE
XE
XE
XE
XE
XE
XE
oS
oS
xs
xs
xs
xs
xs
xs
xs
xs
"}
(43,1,1) = {"
xs
xs
xs
xs
xs
xs
xs
xs
oS
oS
oS
oS
oS
oS
oS
oS
oS
oS
oS
oS
oS
oS
oS
oS
oS
oS
oS
oS
oS
oS
oS
oS
oS
oS
oS
oS
oS
oS
oS
oS
oS
oS
oS
oS
xs
xs
xs
xs
xs
xs
xs
xs
"}
(44,1,1) = {"
xs
xs
xs
xs
xs
xs
xs
xs
oS
oS
oS
oS
oS
oS
oS
oS
oS
oS
oS
oS
oS
oS
oS
oS
oS
oS
oS
oS
oS
oS
oS
oS
oS
oS
oS
oS
oS
oS
oS
oS
oS
oS
oS
oS
xs
xs
xs
xs
xs
xs
xs
xs
"}
(45,1,1) = {"
xs
xs
xs
xs
xs
xs
xs
xs
xs
xs
xs
xs
xs
xs
xs
xs
xs
xs
xs
xs
xs
xs
xs
xs
xs
xs
xs
xs
xs
xs
xs
xs
xs
xs
xs
xs
xs
xs
xs
xs
xs
xs
xs
xs
xs
xs
xs
xs
xs
xs
xs
xs
"}
(46,1,1) = {"
xs
xs
xs
xs
xs
xs
xs
xs
xs
xs
xs
xs
xs
xs
xs
xs
xs
xs
xs
xs
xs
xs
xs
xs
xs
xs
xs
xs
xs
xs
xs
xs
xs
xs
xs
xs
xs
xs
xs
xs
xs
xs
xs
xs
xs
xs
xs
xs
xs
xs
xs
xs
"}
(47,1,1) = {"
xs
xs
xs
xs
xs
xs
xs
xs
xs
xs
xs
xs
xs
xs
xs
xs
xs
xs
xs
xs
xs
xs
xs
xs
xs
xs
xs
xs
xs
xs
xs
xs
xs
xs
xs
xs
xs
xs
xs
xs
xs
xs
xs
xs
xs
xs
xs
xs
xs
xs
xs
xs
"}
(48,1,1) = {"
xs
xs
xs
xs
xs
xs
xs
xs
xs
xs
xs
xs
xs
xs
xs
xs
xs
xs
xs
xs
xs
xs
xs
xs
xs
xs
xs
xs
xs
xs
xs
xs
xs
xs
xs
xs
xs
xs
xs
xs
xs
xs
xs
xs
xs
xs
xs
xs
xs
xs
xs
xs
"}
(49,1,1) = {"
xs
xs
xs
xs
xs
xs
xs
xs
xs
xs
xs
xs
xs
xs
xs
xs
xs
xs
xs
xs
xs
xs
xs
xs
xs
xs
xs
xs
xs
xs
xs
xs
xs
xs
xs
xs
xs
xs
xs
xs
xs
xs
xs
xs
xs
xs
xs
xs
xs
xs
xs
xs
"}
(50,1,1) = {"
xs
xs
xs
xs
xs
xs
xs
xs
xs
xs
xs
xs
xs
xs
xs
xs
xs
xs
xs
xs
xs
xs
xs
xs
xs
xs
xs
xs
xs
xs
xs
xs
xs
xs
xs
xs
xs
xs
xs
xs
xs
xs
xs
xs
xs
xs
xs
xs
xs
xs
xs
xs
"}
(51,1,1) = {"
xs
xs
xs
xs
xs
xs
xs
xs
xs
xs
xs
xs
xs
xs
xs
xs
xs
xs
xs
xs
xs
xs
xs
xs
xs
xs
xs
xs
xs
xs
xs
xs
xs
xs
xs
xs
xs
xs
xs
xs
xs
xs
xs
xs
xs
xs
xs
xs
xs
xs
xs
xs
"}
(52,1,1) = {"
xs
xs
xs
xs
xs
xs
xs
xs
xs
xs
xs
xs
xs
xs
xs
xs
xs
xs
xs
xs
xs
xs
xs
xs
xs
xs
xs
xs
xs
xs
xs
xs
xs
xs
xs
xs
xs
xs
xs
xs
xs
xs
xs
xs
xs
xs
xs
xs
xs
xs
xs
xs
"}
