//MAP CONVERTED BY dmm2tgm.py THIS HEADER COMMENT PREVENTS RECONVERSION, DO NOT REMOVE
"a" = (
/turf/space,
/area/space)
"b" = (
/obj/effect/landmark/map_data{
	height = 2
	},
/turf/space,
/area/space)
"c" = (
/turf/simulated/wall,
/area/medical/surgery)
"d" = (
/obj/effect/floor_decal/corner/blue/diagonal,
/obj/structure/iv_drip,
/obj/item/chems/ivbag/blood/OMinus,
/obj/item/chems/ivbag/blood/OMinus,
/obj/item/chems/ivbag/blood/OMinus,
/turf/simulated/floor/tiled/white,
/area/medical/surgery)
"e" = (
/obj/effect/floor_decal/corner/blue/diagonal,
/obj/machinery/optable,
/turf/simulated/floor/tiled/white,
/area/medical/surgery)
"f" = (
/obj/effect/floor_decal/corner/blue/diagonal,
/obj/machinery/computer/operating,
/turf/simulated/floor/tiled/white,
/area/medical/surgery)
"g" = (
/obj/machinery/light{
	dir = 1
	},
/obj/effect/floor_decal/corner/blue/diagonal,
/obj/structure/table/glass,
/obj/item/storage/box/syringes,
/obj/item/storage/box/freezer,
/turf/simulated/floor/tiled/white,
/area/medical/surgery)
"h" = (
/obj/effect/floor_decal/corner/blue/diagonal,
/obj/structure/table/glass,
/obj/item/storage/box/gloves,
/obj/item/storage/box/masks,
/turf/simulated/floor/tiled/white,
/area/medical/surgery)
"i" = (
/obj/effect/floor_decal/corner/blue/diagonal,
/obj/machinery/atmospherics/portables_connector,
/turf/simulated/floor/tiled/white,
/area/medical/surgery)
"j" = (
/obj/structure/lattice,
/turf/simulated/open,
/area/medical/surgery)
"k" = (
/obj/machinery/light{
	dir = 1
	},
/obj/effect/floor_decal/corner/blue/diagonal,
/turf/simulated/floor/tiled/white,
/area/medical/surgery)
"l" = (
/obj/effect/floor_decal/corner/blue/diagonal,
/obj/structure/table/glass,
/obj/item/storage/firstaid/surgery,
/turf/simulated/floor/tiled/white,
/area/medical/surgery)
"m" = (
/obj/effect/floor_decal/corner/blue/diagonal,
/obj/structure/hygiene/sink{
	icon_state = "sink";
	dir = 4
	},
/turf/simulated/floor/tiled/white,
/area/medical/surgery)
"n" = (
/turf/simulated/open,
/area/medical/surgery)
"o" = (
/obj/effect/floor_decal/corner/blue/diagonal,
/obj/structure/table/glass,
/obj/item/chems/dropper,
/obj/item/stack/nanopaste,
/obj/machinery/light{
	icon_state = "tube1";
	dir = 8
	},
/turf/simulated/floor/tiled/white,
/area/medical/surgery)
"p" = (
/obj/effect/floor_decal/corner/blue/diagonal,
/obj/machinery/body_scanconsole{
	icon_state = "body_scannerconsole";
	dir = 4
	},
/turf/simulated/floor/tiled/white,
/area/medical/surgery)
"q" = (
/obj/effect/floor_decal/corner/blue/diagonal,
/obj/machinery/bodyscanner{
	icon_state = "body_scanner_0";
	dir = 4
	},
/turf/simulated/floor/tiled/white,
/area/medical/surgery)
"r" = (
/obj/effect/floor_decal/corner/blue/diagonal,
/obj/machinery/sleeper/standard{
	icon_state = "sleeper_0";
	dir = 8
	},
/turf/simulated/floor/tiled/white,
/area/medical/surgery)
"s" = (
/obj/machinery/light_switch{
	pixel_x = 25
	},
/obj/effect/floor_decal/corner/blue/diagonal,
/turf/simulated/floor/tiled/white,
/area/medical/surgery)
"t" = (
/obj/effect/floor_decal/corner/blue/diagonal,
/obj/structure/table/glass,
/obj/item/scalpel/laser1,
/obj/item/scalpel/laser2,
/obj/item/scalpel/laser3,
/obj/item/robotanalyzer,
/obj/item/scanner/health,
/obj/item/storage/firstaid/adv,
/turf/simulated/floor/tiled/white,
/area/medical/surgery)
"u" = (
/obj/effect/floor_decal/corner/blue/diagonal,
/obj/structure/ladder,
/turf/simulated/floor/tiled/white,
/area/medical/surgery)
"v" = (
/obj/effect/floor_decal/corner/blue/diagonal,
/obj/machinery/atmospherics/unary/freezer,
/turf/simulated/floor/tiled/white,
/area/medical/surgery)
"w" = (
/obj/effect/floor_decal/corner/blue/diagonal,
/turf/simulated/floor/tiled/white,
/area/medical/surgery)
"x" = (
/obj/effect/floor_decal/corner/blue/diagonal,
/obj/machinery/portable_atmospherics/canister/oxygen/prechilled,
/obj/machinery/atmospherics/portables_connector,
/turf/simulated/floor/tiled/white,
/area/medical/surgery)
"y" = (
/obj/effect/floor_decal/corner/blue/diagonal,
/obj/machinery/light{
	icon_state = "tube1";
	dir = 4
	},
/turf/simulated/floor/tiled/white,
/area/medical/surgery)
"z" = (
/obj/effect/floor_decal/corner/blue/diagonal,
/obj/structure/closet/secure_closet/freezer/meat,
/turf/simulated/floor/tiled/white,
/area/medical/surgery)
"A" = (
/obj/effect/floor_decal/corner/blue/diagonal,
/obj/machinery/robotics_fabricator,
/turf/simulated/floor/tiled/white,
/area/medical/surgery)
"B" = (
/obj/effect/floor_decal/corner/blue/diagonal,
/obj/machinery/atmospherics/pipe/simple/visible/blue{
	icon_state = "intact";
	dir = 5
	},
/turf/simulated/floor/tiled/white,
/area/medical/surgery)
"C" = (
/obj/effect/floor_decal/corner/blue/diagonal,
/obj/machinery/atmospherics/pipe/manifold/visible/blue,
/turf/simulated/floor/tiled/white,
/area/medical/surgery)
"D" = (
/obj/effect/floor_decal/corner/blue/diagonal,
/obj/machinery/atmospherics/pipe/simple/visible/blue{
	icon_state = "intact";
	dir = 9
	},
/turf/simulated/floor/tiled/white,
/area/medical/surgery)
"E" = (
/obj/machinery/atmospherics/unary/vent_pump/on,
/obj/effect/floor_decal/corner/blue/diagonal,
/turf/simulated/floor/tiled/white,
/area/medical/surgery)
"F" = (
/obj/effect/floor_decal/corner/blue/diagonal,
/obj/machinery/organ_printer/flesh/mapped,
/turf/simulated/floor/tiled/white,
/area/medical/surgery)
"G" = (
/obj/machinery/atmospherics/pipe/simple/visible{
	icon_state = "intact";
	dir = 5
	},
/obj/effect/floor_decal/corner/blue/diagonal,
/turf/simulated/floor/tiled/white,
/area/medical/surgery)
"H" = (
/obj/machinery/atmospherics/pipe/simple/visible{
	icon_state = "intact";
	dir = 4
	},
/obj/effect/floor_decal/corner/blue/diagonal,
/turf/simulated/floor/tiled/white,
/area/medical/surgery)
"I" = (
/obj/machinery/atmospherics/portables_connector{
	icon_state = "map_connector";
	dir = 8
	},
/obj/machinery/portable_atmospherics/canister/air,
/obj/effect/floor_decal/corner/blue/diagonal,
/turf/simulated/floor/tiled/white,
/area/medical/surgery)
"J" = (
/obj/effect/floor_decal/corner/blue/diagonal,
/obj/machinery/organ_printer/robot/mapped,
/turf/simulated/floor/tiled/white,
/area/medical/surgery)
"K" = (
/obj/effect/floor_decal/corner/blue/diagonal,
/obj/structure/table/rack,
/obj/item/stack/material/plasteel/fifty,
/obj/item/stack/material/steel/fifty,
/obj/item/stack/material/glass/fifty,
/obj/item/stack/material/gold/ten,
/obj/item/stack/material/mhydrogen/ten,
/obj/item/stack/material/silver/ten,
/obj/item/stack/material/uranium/ten,
/obj/item/stack/material/diamond/ten,
/obj/item/stack/material/phoron/fifty,
/obj/item/storage/belt/utility/full,
/obj/item/stack/material/steel/fifty,
/turf/simulated/floor/tiled/white,
/area/medical/surgery)
"L" = (
/obj/machinery/atmospherics/pipe/simple/visible{
	icon_state = "intact";
	dir = 6
	},
/obj/effect/floor_decal/corner/blue/diagonal,
/turf/simulated/floor/tiled/white,
/area/medical/surgery)
"M" = (
/obj/machinery/atmospherics/portables_connector{
	icon_state = "map_connector";
	dir = 8
	},
/obj/machinery/portable_atmospherics/canister/empty,
/obj/effect/floor_decal/corner/blue/diagonal,
/turf/simulated/floor/tiled/white,
/area/medical/surgery)
"N" = (
/obj/effect/floor_decal/corner/blue/diagonal,
/obj/machinery/computer/rdservercontrol,
/turf/simulated/floor/tiled/white,
/area/medical/surgery)
"O" = (
/obj/machinery/atmospherics/unary/vent_scrubber/on{
	icon_state = "map_scrubber_on";
	dir = 1
	},
/obj/effect/floor_decal/corner/blue/diagonal,
/turf/simulated/floor/tiled/white,
/area/medical/surgery)
"P" = (
/obj/machinery/light{
	icon_state = "tube1";
	dir = 8
	},
/obj/effect/floor_decal/corner/blue/diagonal,
/obj/machinery/r_n_d/server/core,
/turf/simulated/floor/tiled/white,
/area/medical/surgery)
"Q" = (
/obj/machinery/light{
	icon_state = "tube1";
	dir = 4
	},
/obj/effect/floor_decal/corner/blue/diagonal,
/turf/simulated/floor/tiled/white,
/area/medical/surgery)
"R" = (
/obj/structure/cable{
	d2 = 2;
	icon_state = "0-2";
	pixel_y = 0
	},
/obj/machinery/power/apc{
	dir = 8;
	name = "west bump";
	pixel_x = -24
	},
/obj/effect/floor_decal/corner/blue/diagonal,
/turf/simulated/floor/tiled/white,
/area/medical/surgery)
"S" = (
/obj/structure/cable{
	d1 = 1;
	d2 = 2;
	icon_state = "1-2";
	pixel_y = 0
	},
/obj/effect/floor_decal/corner/blue/diagonal,
/turf/simulated/floor/tiled/white,
/area/medical/surgery)
"T" = (
/obj/structure/cable,
/obj/machinery/power/debug_items/infinite_generator,
/obj/effect/floor_decal/corner/blue/diagonal,
/turf/simulated/floor/tiled/white,
/area/medical/surgery)
"U" = (
/obj/machinery/light,
/obj/effect/floor_decal/corner/blue/diagonal,
/turf/simulated/floor/tiled/white,
/area/medical/surgery)
"V" = (
/obj/machinery/light,
/obj/effect/floor_decal/corner/blue/diagonal,
/obj/machinery/r_n_d/protolathe,
/turf/simulated/floor/tiled/white,
/area/medical/surgery)
"W" = (
/obj/effect/floor_decal/corner/blue/diagonal,
/obj/machinery/r_n_d/circuit_imprinter,
/turf/simulated/floor/tiled/white,
/area/medical/surgery)
"X" = (
/obj/effect/floor_decal/corner/blue/diagonal,
/obj/machinery/r_n_d/destructive_analyzer,
/turf/simulated/floor/tiled/white,
/area/medical/surgery)
"Y" = (
/obj/effect/floor_decal/corner/blue/diagonal,
/obj/machinery/computer/rdconsole,
/turf/simulated/floor/tiled/white,
/area/medical/surgery)
"Z" = (
/obj/effect/floor_decal/corner/blue/diagonal,
/obj/machinery/light_switch{
	pixel_x = -25
	},
/turf/simulated/floor/tiled/white,
/area/medical/surgery)

(1,1,1) = {"
a
a
a
a
a
a
a
a
a
a
a
a
a
a
a
a
a
a
a
a
a
a
a
a
a
a
a
a
a
a
a
a
"}
(2,1,1) = {"
a
a
a
a
a
a
a
a
a
a
a
a
a
a
a
a
a
a
a
a
a
a
a
a
a
a
a
a
a
a
a
a
"}
(3,1,1) = {"
a
a
a
a
a
a
a
a
a
a
a
a
a
a
a
a
a
a
a
a
a
a
a
a
a
a
a
a
a
a
a
a
"}
(4,1,1) = {"
a
a
a
a
a
a
a
a
a
a
a
a
a
a
a
a
a
a
a
a
a
a
a
a
a
a
a
a
a
a
a
a
"}
(5,1,1) = {"
a
a
a
a
a
a
a
a
a
a
a
a
a
a
a
a
a
a
a
a
a
a
a
a
a
a
a
a
a
a
a
a
"}
(6,1,1) = {"
a
a
a
a
a
a
a
a
a
a
a
a
a
a
a
a
a
a
a
a
a
a
a
a
a
a
a
a
a
a
a
a
"}
(7,1,1) = {"
a
a
a
a
a
a
a
a
a
a
a
a
a
a
a
a
a
a
a
a
a
a
a
a
a
a
a
a
a
a
a
a
"}
(8,1,1) = {"
a
a
a
a
a
a
a
a
a
a
a
a
a
a
a
a
a
a
a
a
a
a
a
a
a
a
a
a
a
a
a
a
"}
(9,1,1) = {"
a
a
a
a
a
a
a
a
a
a
a
a
a
a
a
a
a
a
a
a
a
a
a
a
a
a
a
a
a
a
a
a
"}
(10,1,1) = {"
a
a
a
a
a
a
a
a
a
a
a
a
a
a
a
a
a
a
a
a
a
a
a
a
a
a
a
a
a
a
a
a
"}
(11,1,1) = {"
a
a
a
a
a
a
a
a
a
a
a
a
a
a
a
a
a
a
a
a
a
a
a
a
a
a
a
a
a
a
a
a
"}
(12,1,1) = {"
a
a
a
a
a
a
a
a
a
a
a
a
a
a
a
a
a
a
a
a
a
a
a
a
a
a
a
a
a
a
a
a
"}
(13,1,1) = {"
a
a
a
a
a
a
a
a
a
a
a
a
a
a
a
a
a
a
a
a
a
a
a
a
a
a
a
a
a
a
a
a
"}
(14,1,1) = {"
a
a
a
a
a
a
a
a
a
b
a
a
a
a
a
a
a
a
a
a
a
a
a
a
a
a
a
a
a
a
a
a
"}
(15,1,1) = {"
a
a
a
a
a
a
a
a
a
a
a
a
a
a
a
a
a
a
a
a
a
a
a
a
a
a
a
a
a
a
a
a
"}
(16,1,1) = {"
a
a
a
a
a
a
a
a
a
a
a
a
a
a
a
a
a
a
a
a
a
a
a
a
a
a
a
a
a
a
a
a
"}
(17,1,1) = {"
a
a
a
a
a
a
a
a
a
a
a
a
a
a
a
a
a
a
a
a
a
a
a
a
a
a
a
a
a
a
a
a
"}
(18,1,1) = {"
a
a
a
a
a
a
a
a
a
c
c
c
c
c
c
c
c
c
c
c
c
c
c
c
a
a
a
a
a
a
a
a
"}
(19,1,1) = {"
a
a
a
a
a
a
a
a
a
c
d
l
o
t
z
F
J
Z
N
P
R
S
T
c
a
a
a
a
a
a
a
a
"}
(20,1,1) = {"
a
a
a
a
a
a
a
a
a
c
e
w
p
w
w
w
w
w
w
w
w
w
W
c
a
a
a
a
a
a
a
a
"}
(21,1,1) = {"
a
a
a
a
a
a
a
a
a
c
f
w
q
w
A
w
K
w
w
w
w
w
X
c
a
a
a
a
a
a
a
a
"}
(22,1,1) = {"
a
a
a
a
a
a
a
a
a
c
g
w
w
w
w
w
w
w
w
w
w
w
V
c
a
a
a
a
a
a
a
a
"}
(23,1,1) = {"
a
a
a
a
a
a
a
a
a
c
h
m
r
u
w
w
w
w
w
w
w
w
Y
c
a
a
a
a
a
a
a
a
"}
(24,1,1) = {"
a
a
a
a
a
a
a
a
a
c
w
j
n
v
B
w
w
w
w
w
w
w
w
c
a
a
a
a
a
a
a
a
"}
(25,1,1) = {"
a
a
a
a
a
a
a
a
a
c
j
j
n
i
C
w
w
w
w
w
w
w
w
c
a
a
a
a
a
a
a
a
"}
(26,1,1) = {"
a
a
a
a
a
a
a
a
a
c
w
n
n
x
D
w
w
w
w
w
w
w
w
c
a
a
a
a
a
a
a
a
"}
(27,1,1) = {"
a
a
a
a
a
a
a
a
a
c
w
w
w
w
w
w
w
w
w
w
w
w
w
c
a
a
a
a
a
a
a
a
"}
(28,1,1) = {"
a
a
a
a
a
a
a
a
a
c
k
w
w
w
w
w
w
w
w
w
w
w
U
c
a
a
a
a
a
a
a
a
"}
(29,1,1) = {"
a
a
a
a
a
a
a
a
a
c
w
w
w
w
E
G
w
L
O
w
w
w
w
c
a
a
a
a
a
a
a
a
"}
(30,1,1) = {"
a
a
a
a
a
a
a
a
a
c
w
w
w
w
w
H
w
H
w
w
w
w
w
c
a
a
a
a
a
a
a
a
"}
(31,1,1) = {"
a
a
a
a
a
a
a
a
a
c
w
w
s
y
w
I
w
M
w
Q
w
w
w
c
a
a
a
a
a
a
a
a
"}
(32,1,1) = {"
a
a
a
a
a
a
a
a
a
c
c
c
c
c
c
c
c
c
c
c
c
c
c
c
a
a
a
a
a
a
a
a
"}
(33,1,1) = {"
a
a
a
a
a
a
a
a
a
a
a
a
a
a
a
a
a
a
a
a
a
a
a
a
a
a
a
a
a
a
a
a
"}
(34,1,1) = {"
a
a
a
a
a
a
a
a
a
a
a
a
a
a
a
a
a
a
a
a
a
a
a
a
a
a
a
a
a
a
a
a
"}
(35,1,1) = {"
a
a
a
a
a
a
a
a
a
a
a
a
a
a
a
a
a
a
a
a
a
a
a
a
a
a
a
a
a
a
a
a
"}
(36,1,1) = {"
a
a
a
a
a
a
a
a
a
a
a
a
a
a
a
a
a
a
a
a
a
a
a
a
a
a
a
a
a
a
a
a
"}
(37,1,1) = {"
a
a
a
a
a
a
a
a
a
a
a
a
a
a
a
a
a
a
a
a
a
a
a
a
a
a
a
a
a
a
a
a
"}
(38,1,1) = {"
a
a
a
a
a
a
a
a
a
a
a
a
a
a
a
a
a
a
a
a
a
a
a
a
a
a
a
a
a
a
a
a
"}
(39,1,1) = {"
a
a
a
a
a
a
a
a
a
a
a
a
a
a
a
a
a
a
a
a
a
a
a
a
a
a
a
a
a
a
a
a
"}
(40,1,1) = {"
a
a
a
a
a
a
a
a
a
a
a
a
a
a
a
a
a
a
a
a
a
a
a
a
a
a
a
a
a
a
a
a
"}
(41,1,1) = {"
a
a
a
a
a
a
a
a
a
a
a
a
a
a
a
a
a
a
a
a
a
a
a
a
a
a
a
a
a
a
a
a
"}
(42,1,1) = {"
a
a
a
a
a
a
a
a
a
a
a
a
a
a
a
a
a
a
a
a
a
a
a
a
a
a
a
a
a
a
a
a
"}
(43,1,1) = {"
a
a
a
a
a
a
a
a
a
a
a
a
a
a
a
a
a
a
a
a
a
a
a
a
a
a
a
a
a
a
a
a
"}
(44,1,1) = {"
a
a
a
a
a
a
a
a
a
a
a
a
a
a
a
a
a
a
a
a
a
a
a
a
a
a
a
a
a
a
a
a
"}
(45,1,1) = {"
a
a
a
a
a
a
a
a
a
a
a
a
a
a
a
a
a
a
a
a
a
a
a
a
a
a
a
a
a
a
a
a
"}
(46,1,1) = {"
a
a
a
a
a
a
a
a
a
a
a
a
a
a
a
a
a
a
a
a
a
a
a
a
a
a
a
a
a
a
a
a
"}
(47,1,1) = {"
a
a
a
a
a
a
a
a
a
a
a
a
a
a
a
a
a
a
a
a
a
a
a
a
a
a
a
a
a
a
a
a
"}
(48,1,1) = {"
a
a
a
a
a
a
a
a
a
a
a
a
a
a
a
a
a
a
a
a
a
a
a
a
a
a
a
a
a
a
a
a
"}
