//MAP CONVERTED BY dmm2tgm.py THIS HEADER COMMENT PREVENTS RECONVERSION, DO NOT REMOVE
"a" = (
/turf/floor/natural/grass/wild,
/area/shaded_hills/outside/point_of_interest/hunter_camp)
"b" = (
/obj/structure/drying_rack,
/turf/floor/natural/dirt,
/area/shaded_hills/outside/point_of_interest/hunter_camp)
"e" = (
/turf/floor/natural/grass,
/area/shaded_hills/outside/point_of_interest/hunter_camp)
"h" = (
/obj/structure/flora/tree/hardwood/ebony,
/turf/floor/natural/grass,
/area/shaded_hills/outside/point_of_interest/hunter_camp)
"j" = (
/obj/item/stack/material/skin/mapped/leather/twenty,
/turf/floor/natural/barren,
/area/shaded_hills/outside/point_of_interest/hunter_camp)
"k" = (
/obj/item/food/butchery/offal,
/obj/item/food/butchery/offal/small,
/obj/structure/pit,
/turf/floor/natural/dirt,
/area/shaded_hills/outside/point_of_interest/hunter_camp)
"n" = (
/turf/floor/natural/dirt,
/area/shaded_hills/outside/point_of_interest/hunter_camp)
"q" = (
/obj/structure/closet/crate/chest/ebony,
/obj/item/food/butchery/haunch/shoulder,
/obj/item/food/butchery/haunch/side,
/turf/floor/natural/barren,
/area/shaded_hills/outside/point_of_interest/hunter_camp)
"A" = (
/obj/abstract/exterior_marker/inside,
/turf/wall/log/walnut,
/area/shaded_hills/outside/point_of_interest/hunter_camp)
"B" = (
/obj/structure/flora/stump/tree/ebony,
/turf/floor/natural/grass/wild,
/area/shaded_hills/outside/point_of_interest/hunter_camp)
"C" = (
/obj/structure/flora/stump/tree/ebony,
/turf/floor/natural/grass,
/area/shaded_hills/outside/point_of_interest/hunter_camp)
"D" = (
/obj/abstract/exterior_marker/inside,
/turf/floor/natural/dirt,
/area/shaded_hills/outside/point_of_interest/hunter_camp)
"E" = (
/obj/structure/reagent_dispensers/barrel/ebony/water,
/turf/floor/natural/barren,
/area/shaded_hills/outside/point_of_interest/hunter_camp)
"F" = (
/obj/structure/drying_rack,
/turf/floor/natural/barren,
/area/shaded_hills/outside/point_of_interest/hunter_camp)
"I" = (
/turf/floor/natural/barren,
/area/shaded_hills/outside/point_of_interest/hunter_camp)
"J" = (
/obj/structure/flora/tree/hardwood/ebony,
/turf/floor/natural/grass/wild,
/area/shaded_hills/outside/point_of_interest/hunter_camp)
"K" = (
/turf/template_noop,
/area/template_noop)
"P" = (
/obj/structure/flora/tree/hardwood/mahogany,
/turf/floor/natural/grass/wild,
/area/shaded_hills/outside/point_of_interest/hunter_camp)
"Q" = (
/obj/structure/bed/bedroll/fur,
/obj/abstract/exterior_marker/inside,
/turf/floor/natural/barren,
/area/shaded_hills/outside/point_of_interest/hunter_camp)
"S" = (
/obj/structure/fire_source/firepit/basalt,
/obj/item/stack/material/log/mapped/walnut/fifteen,
/turf/floor/natural/barren,
/area/shaded_hills/outside/point_of_interest/hunter_camp)
"U" = (
/obj/abstract/exterior_marker/inside,
/turf/floor/natural/barren,
/area/shaded_hills/outside/point_of_interest/hunter_camp)
"Z" = (
/obj/item/bladed/knife,
/turf/floor/natural/barren,
/area/shaded_hills/outside/point_of_interest/hunter_camp)

(1,1,1) = {"
K
K
K
K
K
K
K
K
K
K
e
e
e
e
K
K
K
K
K
K
"}
(2,1,1) = {"
K
a
K
e
e
K
K
K
e
e
e
e
a
a
a
K
K
K
K
K
"}
(3,1,1) = {"
a
a
a
e
e
e
e
e
e
e
h
a
a
a
a
a
a
K
K
K
"}
(4,1,1) = {"
a
a
a
e
e
e
e
h
e
a
a
a
J
B
a
P
a
a
K
K
"}
(5,1,1) = {"
K
a
a
e
e
C
e
e
a
a
n
n
a
a
a
a
a
a
K
K
"}
(6,1,1) = {"
e
a
a
B
a
e
e
n
n
n
n
n
n
e
a
B
a
a
e
K
"}
(7,1,1) = {"
e
a
a
P
e
e
n
n
n
n
n
k
n
n
e
a
a
e
a
K
"}
(8,1,1) = {"
e
a
a
a
a
n
A
D
U
I
n
n
n
n
n
e
e
e
e
e
"}
(9,1,1) = {"
K
e
a
a
a
n
D
Q
U
I
I
I
E
n
n
n
e
e
e
e
"}
(10,1,1) = {"
K
K
e
a
a
n
D
U
U
S
I
I
I
I
n
n
e
h
a
a
"}
(11,1,1) = {"
K
e
e
e
e
n
A
U
U
I
I
j
F
I
n
n
e
B
a
a
"}
(12,1,1) = {"
K
e
e
e
e
e
n
n
I
q
Z
b
n
n
n
e
a
a
J
K
"}
(13,1,1) = {"
K
e
e
e
e
e
n
n
n
n
n
n
n
e
e
e
a
a
a
K
"}
(14,1,1) = {"
K
e
e
e
C
e
e
n
n
n
n
n
e
e
a
a
B
a
a
K
"}
(15,1,1) = {"
K
K
e
e
e
e
e
e
a
B
a
e
e
e
e
a
a
a
a
K
"}
(16,1,1) = {"
K
K
K
e
e
J
a
a
P
a
a
e
e
e
a
a
a
a
a
K
"}
(17,1,1) = {"
K
K
K
e
e
a
a
B
a
a
a
a
a
e
h
a
a
a
K
K
"}
(18,1,1) = {"
K
K
K
K
e
e
a
a
a
a
a
a
a
a
a
a
a
K
K
K
"}
(19,1,1) = {"
K
K
K
K
K
e
e
e
e
a
a
a
J
a
a
a
a
K
K
K
"}
(20,1,1) = {"
K
K
K
K
K
K
K
e
e
e
e
K
K
K
K
K
K
K
K
K
"}
